state,county,fips,POP tot,0-19 tot,20-64tot,65+ tot,voting age
Alabama,Autauga,01001,55869,14252,32693,8924,41617
Alabama,Baldwin,01003,223234,52268,124136,46830,170966
Alabama,Barbour,01005,24686,5595,14230,4861,19091
Alabama,Bibb,01007,22394,4992,13669,3733,17402
Alabama,Blount,01009,57826,14522,32490,10814,43304
Alabama,Bullock,01011,10101,2315,6075,1711,7786
Alabama,Butler,01013,19448,4692,10707,4049,14756
Alabama,Calhoun,01015,113605,27548,65510,20547,86057
Alabama,Chambers,01017,33254,7592,18947,6715,25662
Alabama,Cherokee,01019,26196,5499,14533,6164,20697
Alabama,Chilton,01021,44428,11572,25256,7600,32856
Alabama,Choctaw,01023,12589,2738,6882,2969,9851
Alabama,Clarke,01025,23622,5584,13195,4843,18038
Alabama,Clay,01027,13235,2956,7494,2785,10279
Alabama,Cleburne,01029,14910,3672,8230,3008,11238
Alabama,Coffee,01031,52342,13572,29739,9031,38770
Alabama,Colbert,01033,55241,12686,31490,11065,42555
Alabama,Conecuh,01035,12067,2728,6507,2832,9339
Alabama,Coosa,01037,10663,1922,6173,2568,8741
Alabama,Covington,01039,37049,8871,20258,7920,28178
Alabama,Crenshaw,01041,13772,3426,7675,2671,10346
Alabama,Cullman,01043,83768,20604,47429,15735,63164
Alabama,Dale,01045,49172,12321,28349,8502,36851
Alabama,Dallas,01047,37196,9693,20482,7021,27503
Alabama,DeKalb,01049,71513,18843,40069,12601,52670
Alabama,Elmore,01051,81209,19990,48562,12657,61219
Alabama,Escambia,01053,36633,8989,20953,6691,27644
Alabama,Etowah,01055,102268,24105,58367,19796,78163
Alabama,Fayette,01057,16302,3767,8990,3545,12535
Alabama,Franklin,01059,31362,8488,17500,5374,22874
Alabama,Geneva,01061,26271,6332,14519,5420,19939
Alabama,Greene,01063,8111,1927,4294,1890,6184
Alabama,Hale,01065,14651,3715,8051,2885,10936
Alabama,Henry,01067,17205,3843,9331,4031,13362
Alabama,Houston,01069,105882,26620,60078,19184,79262
Alabama,Jackson,01071,51626,11775,29260,10591,39851
Alabama,Jefferson,01073,658573,166418,384826,107329,492155
Alabama,Lamar,01075,13805,3223,7522,3060,10582
Alabama,Lauderdale,01077,92729,20897,52825,19007,71832
Alabama,Lawrence,01079,32924,7783,18854,6287,25141
Alabama,Lee,01081,164542,42352,101778,20412,122190
Alabama,Limestone,01083,98915,24290,59544,15081,74625
Alabama,Lowndes,01085,9726,2355,5450,1921,7371
Alabama,Macon,01087,18068,4102,10181,3785,13966
Alabama,Madison,01089,372909,91034,224739,57136,281875
Alabama,Marengo,01091,18863,4679,10435,3749,14184
Alabama,Marion,01093,29709,6801,16519,6389,22908
Alabama,Marshall,01095,96774,26498,53526,16750,70276
Alabama,Mobile,01097,413210,106527,237941,68742,306683
Alabama,Monroe,01099,20733,4866,11482,4385,15867
Alabama,Montgomery,01101,226486,59380,131825,35281,167106
Alabama,Morgan,01103,119679,29904,68434,21341,89775
Alabama,Perry,01105,8923,2371,4757,1795,6552
Alabama,Pickens,01107,19930,4333,11711,3886,15597
Alabama,Pike,01109,33114,8173,19910,5031,24941
Alabama,Randolph,01111,22722,5419,12562,4741,17303
Alabama,Russell,01113,57961,15282,34090,8589,42679
Alabama,St. Clair,01115,89512,21939,52490,15083,67573
Alabama,Shelby,01117,217702,55803,127175,34724,161899
Alabama,Sumter,01119,12427,2978,7124,2325,9449
Alabama,Talladega,01121,79978,18692,46517,14769,61286
Alabama,Tallapoosa,01123,40367,9038,22342,8987,31329
Alabama,Tuscaloosa,01125,209355,53864,126702,28789,155491
Alabama,Walker,01127,63521,15450,35662,12409,48071
Alabama,Washington,01129,16326,3969,9138,3219,12357
Alabama,Wilcox,01131,10373,2729,5539,2105,7644
Alabama,Winston,01133,23629,5275,13187,5167,18354
Alaska,Aleutians East Borough,02013,3337,528,2322,487,2809
Alaska,Aleutians West Census Area,02016,5634,983,3816,835,4651
Alaska,Anchorage,02020,280219,44366,193838,42015,235853
Alaska,Bethel Census Area,02050,18386,2802,12783,2801,15584
Alaska,Bristol Bay Borough,02060,836,142,572,122,694
Alaska,Denali Borough,02068,2097,342,1436,319,1755
Alaska,Dillingham Census Area,02070,4916,786,3381,749,4130
Alaska,Fairbanks North Star Borough,02090,96849,15325,66762,14762,81524
Alaska,Haines Borough,02100,2535,108,2041,386,2427
Alaska,Hoonah-Angoon Census Area,02105,2148,358,1412,378,1790
Alaska,Juneau City and Borough,02110,31974,4925,22177,4872,27049
Alaska,Kenai Peninsula Borough,02122,58708,9108,40651,8949,49600
Alaska,Ketchikan Gateway Borough,02130,13901,2204,9578,2119,11697
Alaska,Kodiak Island Borough,02150,12998,1986,9031,1981,11012
Alaska,Kusilvak Census Area,02158,8314,1307,5740,1267,7007
Alaska,Lake and Peninsula Borough,02164,1592,251,1099,242,1341
Alaska,Matanuska-Susitna Borough,02170,108017,17156,74396,16465,90861
Alaska,Nome Census Area,02180,10004,1586,6964,1454,8418
Alaska,North Slope Borough,02185,9832,1323,7011,1498,8509
Alaska,Northwest Arctic Borough,02188,7621,1156,5334,1131,6465
Alaska,Petersburg Borough,02195,3266,486,2304,476,2780
Alaska,Prince of Wales-Hyder Census Area,02198,6203,979,4280,944,5224
Alaska,Sitka City and Borough,02220,8493,1325,5880,1288,7168
Alaska,Skagway Municipality,02230,1183,189,807,187,994
Alaska,Southeast Fairbanks Census Area,02240,6893,1008,4807,1078,5885
Alaska,Valdez-Cordova Census Area,02261,9202,1446,6428,1328,7756
Alaska,Wrangell City and Borough,02275,2502,385,1738,379,2117
Alaska,Yukon-Koyukuk Census Area,02290,5230,818,3615,797,4412
Alaska,Yakutat,02882,579,89,407,83,490
Alaska,Skagway Municipality,02930,1183,176,835,172,1007
Alaska,Southeast Fairbanks Census Area ,02940,6893,1097,4747,1049,5796
Arizona,Apache,04001,125922,30143,66661,29118,95779
Arizona,Cochise,04003,71887,21424,39129,11334,50463
Arizona,Coconino,04005,143476,38457,86357,18662,105019
Arizona,Gila,04007,54018,11635,26514,15869,42383
Arizona,Graham,04009,38837,11562,21835,5440,27275
Arizona,Greenlee,04011,9498,2793,5408,1297,6705
Arizona,La Paz,04012,21108,3826,8890,8392,17282
Arizona,Maricopa,04013,4485414,1172216,2616867,696331,3313198
Arizona,Mohave,04015,212181,38950,107321,65910,173231
Arizona,Navajo,04017,110924,31876,58219,20829,79048
Arizona,Pima,04019,1047279,247305,587420,212554,799974
Arizona,Pinal,04021,462789,112806,253417,96566,349983
Arizona,Santa Cruz,04023,46498,13768,24139,8591,32730
Arizona,Yavapai,04025,235099,42123,116538,76438,192976
Arizona,Yuma,04027,213787,59714,112771,41302,154073
Arkansas,Arkansas,05001,17486,4352,9583,3551,13134
Arkansas,Ashley,05003,19657,4789,10752,4116,14868
Arkansas,Baxter,05005,41932,8144,20730,13058,33788
Arkansas,Benton,05007,279141,79109,162130,37902,200032
Arkansas,Boone,05009,37432,9277,20314,7841,28155
Arkansas,Bradley,05011,10763,2826,5867,2070,7937
Arkansas,Calhoun,05013,5189,1085,2965,1139,4104
Arkansas,Carroll,05015,28380,6705,14903,6772,21675
Arkansas,Chicot,05017,10118,2428,5554,2136,7690
Arkansas,Clark,05019,22320,5864,12703,3753,16456
Arkansas,Clay,05021,14551,3403,7966,3182,11148
Arkansas,Cleburne,05023,24919,5136,12993,6790,19783
Arkansas,Cleveland,05025,7956,1891,4360,1705,6065
Arkansas,Columbia,05027,23457,6342,12955,4160,17115
Arkansas,Conway,05029,20846,5153,11580,4113,15693
Arkansas,Craighead,05031,110332,31253,63655,15424,79079
Arkansas,Crawford,05033,63257,16833,35575,10849,46424
Arkansas,Crittenden,05035,47955,14190,26805,6960,33765
Arkansas,Cross,05037,16419,4163,9089,3167,12256
Arkansas,Dallas,05039,7009,1595,3704,1710,5414
Arkansas,Desha,05041,11361,3137,5997,2227,8224
Arkansas,Drew,05043,18219,4653,10250,3316,13566
Arkansas,Faulkner,05045,126007,32979,76833,16195,93028
Arkansas,Franklin,05047,17715,4394,9787,3534,13321
Arkansas,Fulton,05049,12477,2874,6354,3249,9603
Arkansas,Garland,05051,99386,21880,53362,24144,77506
Arkansas,Grant,05053,18265,4426,10467,3372,13839
Arkansas,Greene,05055,45325,12038,25915,7372,33287
Arkansas,Hempstead,05057,21532,6020,11530,3982,15512
Arkansas,Hot Spring,05059,33771,7639,19601,6531,26132
Arkansas,Howard,05061,13202,3743,7073,2386,9459
Arkansas,Independence,05063,37825,10258,20776,6791,27567
Arkansas,Izard,05065,13629,2678,7393,3558,10951
Arkansas,Jackson,05067,16719,3679,9985,3055,13040
Arkansas,Jefferson,05069,66824,16621,38189,12014,50203
Arkansas,Johnson,05071,26578,7343,14750,4485,19235
Arkansas,Lafayette,05073,6624,1343,3644,1637,5281
Arkansas,Lawrence,05075,16406,4114,9024,3268,12292
Arkansas,Lee,05077,8857,1802,5268,1787,7055
Arkansas,Lincoln,05079,13024,2419,8535,2070,10605
Arkansas,Little River,05081,12259,2996,6696,2567,9263
Arkansas,Logan,05083,21466,5021,12049,4396,16445
Arkansas,Lonoke,05085,73309,20261,42932,10116,53048
Arkansas,Madison,05087,16576,4209,9156,3211,12367
Arkansas,Marion,05089,16694,3283,8553,4858,13411
Arkansas,Miller,05091,43257,11042,24775,7440,32215
Arkansas,Mississippi,05093,40651,11618,22917,6116,29033
Arkansas,Monroe,05095,6701,1508,3581,1612,5193
Arkansas,Montgomery,05097,8986,1844,4716,2426,7142
Arkansas,Nevada,05099,8252,2061,4459,1732,6191
Arkansas,Newton,05101,7753,1655,3986,2112,6098
Arkansas,Ouachita,05103,23382,5695,12754,4933,17687
Arkansas,Perry,05105,10455,2558,5755,2142,7897
Arkansas,Phillips,05107,17782,5015,9299,3468,12767
Arkansas,Pike,05109,10718,2541,5982,2195,8177
Arkansas,Poinsett,05111,23528,6123,13084,4321,17405
Arkansas,Polk,05113,19964,4955,10292,4717,15009
Arkansas,Pope,05115,64072,17126,36585,10361,46946
Arkansas,Prairie,05117,8062,1797,4337,1928,6265
Arkansas,Pulaski,05119,391911,98944,229944,63023,292967
Arkansas,Randolph,05121,17958,4628,9785,3545,13330
Arkansas,St. Francis,05123,24994,5717,15069,4208,19277
Arkansas,Saline,05125,122437,30822,69388,22227,91615
Arkansas,Scott,05127,10281,2590,5486,2205,7691
Arkansas,Searcy,05129,7881,1715,4118,2048,6166
Arkansas,Sebastian,05131,127827,33834,73007,20986,93993
Arkansas,Sevier,05133,17007,5303,9162,2542,11704
Arkansas,Sharp,05135,17442,3901,8937,4604,13541
Arkansas,Stone,05137,12506,2617,6400,3489,9889
Arkansas,Union,05139,38682,10095,21468,7119,28587
Arkansas,Van Buren,05141,16545,3522,8607,4416,13023
Arkansas,Washington,05143,239187,67351,142917,28919,171836
Arkansas,White,05145,78753,20850,44708,13195,57903
Arkansas,Woodruff,05147,6320,1478,3366,1476,4842
Arkansas,Yell,05149,21341,5675,11808,3858,15666
California,Alameda,06001,1671329,379348,1053218,238763,1291981
California,Alpine,06003,1129,227,604,298,902
California,Amador,06005,39752,6631,22176,10945,33121
California,Butte,06007,219186,52100,126858,40228,167086
California,Calaveras,06009,45905,8630,24409,12866,37275
California,Colusa,06011,21547,6428,11905,3214,15119
California,Contra Costa,06013,1153526,285460,680362,187704,868066
California,Del Norte,06015,27812,6375,16314,5123,21437
California,El Dorado,06017,192843,41933,108606,42304,150910
California,Fresno,06019,999101,309135,564531,125435,689966
California,Glenn,06021,28393,8305,15612,4476,20088
California,Humboldt,06023,135558,30167,80202,25189,105391
California,Imperial,06025,181215,56780,100298,24137,124435
California,Inyo,06027,18039,4077,9734,4228,13962
California,Kern,06029,900202,284136,514911,101155,616066
California,Kings,06031,152940,45366,91546,16028,107574
California,Lake,06033,64386,14860,34677,14849,49526
California,Lassen,06035,30573,5896,19939,4738,24677
California,Los Angeles,06037,10039107,2399105,6226249,1413753,7640002
California,Madera,06039,157327,47285,87469,22573,110042
California,Marin,06041,258826,56769,142653,59404,202057
California,Mariposa,06043,17203,3060,9169,4974,14143
California,Mendocino,06045,86749,20113,46611,20025,66636
California,Merced,06047,277680,91978,154066,31636,185702
California,Modoc,06049,8841,1867,4543,2431,6974
California,Mono,06051,14444,2886,9228,2330,11558
California,Monterey,06053,434061,125583,247747,60731,308478
California,Napa,06055,137744,31118,79469,27157,106626
California,Nevada,06057,99755,18558,52891,28306,81197
California,Orange,06059,3175692,770503,1919621,485568,2405189
California,Placer,06061,398329,96507,222432,79390,301822
California,Plumas,06063,18807,3658,9712,5437,15149
California,Riverside,06065,2470546,683510,1421094,365942,1787036
California,Sacramento,06067,1552058,398160,929016,224882,1153898
California,San Benito,06069,62808,17669,36887,8252,45139
California,San Bernardino,06071,2180085,629595,1289970,260520,1550490
California,San Diego,06073,3338330,805485,2048393,484452,2532845
California,San Francisco,06075,881549,132157,607622,141770,749392
California,San Joaquin,06077,762148,226064,436303,99781,536084
California,San Luis Obispo,06079,283111,62419,161641,59051,220692
California,San Mateo,06081,766573,169899,469797,126877,596674
California,Santa Barbara,06083,446499,119166,257208,70125,327333
California,Santa Clara,06085,1927852,460705,1198940,268207,1467147
California,Santa Cruz,06087,273213,65440,160556,47217,207773
California,Shasta,06089,180080,42627,99384,38069,137453
California,Sierra,06091,3005,535,1507,963,2470
California,Siskiyou,06093,43539,9647,22513,11379,33892
California,Solano,06095,447643,108348,266139,73156,339295
California,Sonoma,06097,494336,107580,284433,102323,386756
California,Stanislaus,06099,550660,162998,313741,73921,387662
California,Sutter,06101,96971,27300,54576,15095,69671
California,Tehama,06103,65084,16869,35435,12780,48215
California,Trinity,06105,12285,2300,6510,3475,9985
California,Tulare,06107,466195,156115,255789,54291,310080
California,Tuolumne,06109,54478,10099,29670,14709,44379
California,Ventura,06111,846006,212631,496670,136705,633375
California,Yolo,06113,220500,59734,132258,28508,160766
California,Yuba,06115,78668,23501,44897,10270,55167
Colorado,Adams,08001,517421,147932,313961,55528,369489
Colorado,Alamosa,08003,16233,4767,9212,2254,11466
Colorado,Arapahoe,08005,656590,166965,401117,88508,489625
Colorado,Archuleta,08007,14029,2708,7487,3834,11321
Colorado,Baca,08009,3581,876,1830,875,2705
Colorado,Bent,08011,5577,952,3572,1053,4625
Colorado,Boulder,08013,326196,75348,202490,48358,250848
Colorado,Broomfield,08014,70465,17084,43306,10075,53381
Colorado,Chaffee,08015,20356,3359,11699,5298,16997
Colorado,Cheyenne,08017,1831,496,950,385,1335
Colorado,Clear Creek,08019,9700,1611,6019,2070,8089
Colorado,Conejos,08021,8205,2304,4268,1633,5901
Colorado,Costilla,08023,3887,820,2020,1047,3067
Colorado,Crowley,08025,6061,764,4447,850,5297
Colorado,Custer,08027,5068,777,2618,1673,4291
Colorado,Delta,08029,31162,6717,16093,8352,24445
Colorado,Denver,08031,727211,153540,486836,86835,573671
Colorado,Dolores,08033,2055,434,1083,538,1621
Colorado,Douglas,08035,351154,97167,210385,43602,253987
Colorado,Eagle,08037,55127,12924,35367,6836,42203
Colorado,Elbert,08039,26729,6304,15823,4602,20425
Colorado,El Paso,08041,720403,191595,433630,95178,528808
Colorado,Fremont,08043,47839,8460,28785,10594,39379
Colorado,Garfield,08045,60061,16454,35319,8288,43607
Colorado,Gilpin,08047,6243,1001,4130,1112,5242
Colorado,Grand,08049,15734,2928,9901,2905,12806
Colorado,Gunnison,08051,17462,3808,11270,2384,13654
Colorado,Hinsdale,08053,820,142,420,258,678
Colorado,Huerfano,08055,6897,1225,3456,2216,5672
Colorado,Jackson,08057,1392,256,812,324,1136
Colorado,Jefferson,08059,582881,125756,358332,98793,457125
Colorado,Kiowa,08061,1406,354,728,324,1052
Colorado,Kit Carson,08063,7097,1955,3757,1385,5142
Colorado,Lake,08065,8127,1791,5148,1188,6336
Colorado,La Plata,08067,56221,12237,33735,10249,43984
Colorado,Larimer,08069,356899,82030,217095,57774,274869
Colorado,Las Animas,08071,14506,3033,7787,3686,11473
Colorado,Lincoln,08073,5701,1255,3442,1004,4446
Colorado,Logan,08075,22409,4805,13548,4056,17604
Colorado,Mesa,08077,154210,37258,86584,30368,116952
Colorado,Mineral,08079,769,120,391,258,649
Colorado,Moffat,08081,13283,3691,7476,2116,9592
Colorado,Montezuma,08083,26183,6195,13984,6004,19988
Colorado,Montrose,08085,42758,9927,22529,10302,32831
Colorado,Morgan,08087,29068,8209,16330,4529,20859
Colorado,Otero,08089,18278,4944,9554,3780,13334
Colorado,Ouray,08091,4952,834,2768,1350,4118
Colorado,Park,08093,18845,3122,11653,4070,15723
Colorado,Phillips,08095,4265,1110,2162,993,3155
Colorado,Pitkin,08097,17767,2871,11290,3606,14896
Colorado,Prowers,08099,12172,3547,6424,2201,8625
Colorado,Pueblo,08101,168424,41995,94496,31933,126429
Colorado,Rio Blanco,08103,6324,1763,3527,1034,4561
Colorado,Rio Grande,08105,11267,2804,6112,2351,8463
Colorado,Routt,08107,25638,5084,16290,4264,20554
Colorado,Saguache,08109,6824,1587,3563,1674,5237
Colorado,San Juan,08111,728,98,442,188,630
Colorado,San Miguel,08113,8179,1520,5394,1265,6659
Colorado,Sedgwick,08115,2248,467,1171,610,1781
Colorado,Summit,08117,31011,5420,21158,4433,25591
Colorado,Teller,08119,25388,4723,14777,5888,20665
Colorado,Washington,08121,4908,1214,2646,1048,3694
Colorado,Weld,08123,324492,93572,190569,40351,230920
Colorado,Yuma,08125,10019,2962,5185,1872,7057
Connecticut,Fairfield,09001,943332,236017,553364,153951,707315
Connecticut,Hartford,09003,891720,209167,527051,155502,682553
Connecticut,Litchfield,09005,180333,36137,104542,39654,144196
Connecticut,Middlesex,09007,162436,32266,96095,34075,130170
Connecticut,New Haven,09009,854757,196682,505452,152623,658075
Connecticut,New London,09011,265206,57951,157420,49835,207255
Connecticut,Tolland,09013,150721,34696,91454,24571,116025
Connecticut,Windham,09015,116782,26666,70083,20033,90116
Delaware,Kent,10001,180786,46483,102680,31623,134303
Delaware,New Castle,10003,558753,135604,333188,89961,423149
Delaware,Sussex,10005,234225,46825,120078,67322,187400
District of Columbia,District of Columbia,11001,705749,149337,469069,87343,556412
Florida,Alachua,12001,269043,62293,167478,39272,206750
Florida,Baker,12003,29210,7604,17489,4117,21606
Florida,Bay,12005,174705,39407,102763,32535,135298
Florida,Bradford,12007,28201,5985,17152,5064,22216
Florida,Brevard,12009,601942,121123,335067,145752,480819
Florida,Broward,12011,1952778,451640,1166542,334596,1501138
Florida,Calhoun,12013,14105,3078,8357,2670,11027
Florida,Charlotte,12015,188910,24806,87032,77072,164104
Florida,Citrus,12017,149657,24156,70563,54938,125501
Florida,Clay,12019,219252,55475,127933,35844,163777
Florida,Collier,12021,384902,71559,186636,126707,313343
Florida,Columbia,12023,71686,17084,40793,13809,54602
Florida,DeSoto,12027,38001,8001,21442,8558,30000
Florida,Dixie,12029,16826,3368,9474,3984,13458
Florida,Duval,12031,957755,237262,581899,138594,720493
Florida,Escambia,12033,318316,77205,186540,54571,241111
Florida,Flagler,12035,115081,21238,57947,35896,93843
Florida,Franklin,12037,12125,2032,7167,2926,10093
Florida,Gadsden,12039,45660,10870,26250,8540,34790
Florida,Gilchrist,12041,18582,4352,10392,3838,14230
Florida,Glades,12043,13811,2242,7761,3808,11569
Florida,Gulf,12045,13639,2728,7297,3614,10911
Florida,Hamilton,12047,14428,3069,8695,2664,11359
Florida,Hardee,12049,26937,7634,14608,4695,19303
Florida,Hendry,12051,42022,12324,23919,5779,29698
Florida,Hernando,12053,193920,38944,101628,53348,154976
Florida,Highlands,12055,106221,19671,48261,38289,86550
Florida,Hillsborough,12057,1471968,362142,895791,214035,1109826
Florida,Holmes,12059,19617,4334,11362,3921,15283
Florida,Indian River,12061,159923,27893,77897,54133,132030
Florida,Jackson,12063,46414,9797,27047,9570,36617
Florida,Jefferson,12065,14246,2606,8129,3511,11640
Florida,Lafayette,12067,8422,1899,5068,1455,6523
Florida,Lake,12069,367118,76141,191591,99386,290977
Florida,Lee,12071,770577,148490,397455,224632,622087
Florida,Leon,12073,293582,71273,181523,40786,222309
Florida,Levy,12075,41503,8841,22226,10436,32662
Florida,Liberty,12077,8354,1607,5491,1256,6747
Florida,Madison,12079,18493,3755,10836,3902,14738
Florida,Manatee,12081,403253,79654,210442,113157,323599
Florida,Marion,12083,365579,74190,184714,106675,291389
Florida,Martin,12085,161000,28758,81482,50760,132242
Florida,Miami-Dade,12086,2716940,612328,1652005,452607,2104612
Florida,Monroe,12087,74228,12387,44213,17628,61841
Florida,Nassau,12089,88625,19117,49277,20231,69508
Florida,Okaloosa,12091,210738,51127,125235,34376,159611
Florida,Okeechobee,12093,42168,9881,23805,8482,32287
Florida,Orange,12095,1393452,345144,876751,171557,1048308
Florida,Osceola,12097,375751,100548,224422,50781,275203
Florida,Palm Beach,12099,1496770,316016,816210,364544,1180754
Florida,Pasco,12101,553947,123431,305065,125451,430516
Florida,Pinellas,12103,974996,171663,555703,247630,803333
Florida,Polk,12105,724777,176873,399736,148168,547904
Florida,Putnam,12107,74521,17217,39629,17675,57304
Florida,St. Johns,12109,264672,63377,146641,54654,201295
Florida,St. Lucie,12111,328297,70760,176609,80928,257537
Florida,Santa Rosa,12113,184313,43998,110194,30121,140315
Florida,Sarasota,12115,433742,67979,203815,161948,365763
Florida,Seminole,12117,471826,108311,288114,75401,363515
Florida,Sumter,12119,132420,10274,45112,77034,122146
Florida,Suwannee,12121,44417,10268,24499,9650,34149
Florida,Taylor,12123,21569,4637,12407,4525,16932
Florida,Union,12125,15237,3332,9588,2317,11905
Florida,Volusia,12127,553284,109813,305660,137811,443471
Florida,Wakulla,12129,33739,7643,20730,5366,26096
Florida,Walton,12131,74071,16329,42765,14977,57742
Florida,Washington,12133,25473,5592,15501,4380,19881
Georgia,Appling,13001,18386,4931,10198,3257,13455
Georgia,Atkinson,13003,8165,2346,4636,1183,5819
Georgia,Bacon,13005,11164,3095,6191,1878,8069
Georgia,Baker,13007,3038,651,1668,719,2387
Georgia,Baldwin,13009,44890,11238,26254,7398,33652
Georgia,Banks,13011,19234,4709,11114,3411,14525
Georgia,Barrow,13013,83240,23213,49423,10604,60027
Georgia,Bartow,13015,107738,28116,64083,15539,79622
Georgia,Ben Hill,13017,16700,4478,9232,2990,12222
Georgia,Berrien,13019,19397,5083,10972,3342,14314
Georgia,Bibb,13021,153159,41907,86745,24507,111252
Georgia,Bleckley,13023,12873,3485,7182,2206,9388
Georgia,Brantley,13025,19109,4858,10968,3283,14251
Georgia,Brooks,13027,15457,3659,8713,3085,11798
Georgia,Bryan,13029,39627,12572,22818,4237,27055
Georgia,Bulloch,13031,79608,22433,47907,9268,57175
Georgia,Burke,13033,22383,6295,12513,3575,16088
Georgia,Butts,13035,24936,5654,15340,3942,19282
Georgia,Calhoun,13037,6189,1172,3992,1025,5017
Georgia,Camden,13039,54666,14522,32368,7776,40144
Georgia,Candler,13043,10803,2936,5857,2010,7867
Georgia,Carroll,13045,119992,33160,70235,16597,86832
Georgia,Catoosa,13047,67580,16769,38520,12291,50811
Georgia,Charlton,13049,13392,2735,8545,2112,10657
Georgia,Chatham,13051,289430,69730,173508,46192,219700
Georgia,Chattahoochee,13053,10907,3069,7308,530,7838
Georgia,Chattooga,13055,24789,6118,14302,4369,18671
Georgia,Cherokee,13057,258773,68179,153011,37583,190594
Georgia,Clarke,13059,128331,31378,82441,14512,96953
Georgia,Clay,13061,2834,610,1449,775,2224
Georgia,Clayton,13063,292256,89005,175084,28167,203251
Georgia,Clinch,13065,6618,1806,3702,1110,4812
Georgia,Cobb,13067,760141,196596,466952,96593,563545
Georgia,Coffee,13069,43273,11745,25438,6090,31528
Georgia,Colquitt,13071,45600,12856,25412,7332,32744
Georgia,Columbia,13073,156714,42939,91878,21897,113775
Georgia,Cook,13075,17270,4711,9666,2893,12559
Georgia,Coweta,13077,148509,39210,88110,21189,109299
Georgia,Crawford,13079,12404,2752,7241,2411,9652
Georgia,Crisp,13081,22372,5859,12204,4309,16513
Georgia,Dade,13083,16116,3695,9181,3240,12421
Georgia,Dawson,13085,26108,5800,15030,5278,20308
Georgia,Decatur,13087,26404,7066,14941,4397,19338
Georgia,DeKalb,13089,759297,191830,469541,97926,567467
Georgia,Dodge,13091,20605,4450,12315,3840,16155
Georgia,Dooly,13093,13390,2482,8084,2824,10908
Georgia,Dougherty,13095,87956,24244,49204,14508,63712
Georgia,Douglas,13097,146343,41505,87472,17366,104838
Georgia,Early,13099,10190,2770,5455,1965,7420
Georgia,Echols,13101,4006,1149,2304,553,2857
Georgia,Effingham,13103,64296,18472,38192,7632,45824
Georgia,Elbert,13105,19194,4570,10537,4087,14624
Georgia,Emanuel,13107,22646,6223,12694,3729,16423
Georgia,Evans,13109,10654,3068,5849,1737,7586
Georgia,Fannin,13111,26188,4683,13488,8017,21505
Georgia,Fayette,13113,114421,29439,63542,21440,84982
Georgia,Floyd,13115,98498,25874,55845,16779,72624
Georgia,Forsyth,13117,244252,71694,142371,30187,172558
Georgia,Franklin,13119,23349,5826,13046,4477,17523
Georgia,Fulton,13121,1063937,259877,676295,127765,804060
Georgia,Gilmer,13123,31369,6534,16824,8011,24835
Georgia,Glascock,13125,2971,716,1711,544,2255
Georgia,Glynn,13127,85292,20201,47093,17998,65091
Georgia,Gordon,13129,57963,15320,33787,8856,42643
Georgia,Grady,13131,24633,6658,13412,4563,17975
Georgia,Greene,13133,18324,3747,9215,5362,14577
Georgia,Gwinnett,13135,936250,274217,564099,97934,662033
Georgia,Habersham,13137,45328,11384,25444,8500,33944
Georgia,Hall,13139,204441,56158,116794,31489,148283
Georgia,Hancock,13141,8457,1436,5006,2015,7021
Georgia,Haralson,13143,29792,7835,17125,4832,21957
Georgia,Harris,13145,35236,8327,20102,6807,26909
Georgia,Hart,13147,26205,5964,14453,5788,20241
Georgia,Heard,13149,11923,2926,6817,2180,8997
Georgia,Henry,13151,234561,65888,140655,28018,168673
Georgia,Houston,13153,157863,44086,93285,20492,113777
Georgia,Irwin,13155,9416,2192,5528,1696,7224
Georgia,Jackson,13157,72977,20028,42250,10699,52949
Georgia,Jasper,13159,14219,3630,8069,2520,10589
Georgia,Jeff Davis,13161,15115,4327,8348,2440,10788
Georgia,Jefferson,13163,15362,3918,8548,2896,11444
Georgia,Jenkins,13165,8676,1933,5236,1507,6743
Georgia,Johnson,13167,9643,2002,5851,1790,7641
Georgia,Jones,13169,28735,7206,16265,5264,21529
Georgia,Lamar,13171,19077,5026,10735,3316,14051
Georgia,Lanier,13173,10423,2727,6226,1470,7696
Georgia,Laurens,13175,47546,12730,26222,8594,34816
Georgia,Lee,13177,29992,8643,17444,3905,21349
Georgia,Liberty,13179,61435,18989,36538,5908,42446
Georgia,Lincoln,13181,7921,1634,4343,1944,6287
Georgia,Long,13183,19559,5768,11804,1987,13791
Georgia,Lowndes,13185,117406,33386,69226,14794,84020
Georgia,Lumpkin,13187,33610,8071,19552,5987,25539
Georgia,McDuffie,13189,21312,5827,11632,3853,15485
Georgia,McIntosh,13191,14378,2510,7822,4046,11868
Georgia,Macon,13193,12947,2715,7888,2344,10232
Georgia,Madison,13195,29880,7476,17207,5197,22404
Georgia,Marion,13197,8359,1907,4709,1743,6452
Georgia,Meriwether,13199,21167,4947,11811,4409,16220
Georgia,Miller,13201,5718,1437,2994,1287,4281
Georgia,Mitchell,13205,21863,5413,12763,3687,16450
Georgia,Monroe,13207,27578,6224,16071,5283,21354
Georgia,Montgomery,13209,9172,2215,5351,1606,6957
Georgia,Morgan,13211,19276,4770,10562,3944,14506
Georgia,Murray,13213,40096,10756,23203,6137,29340
Georgia,Muscogee,13215,195769,53801,115088,26880,141968
Georgia,Newton,13217,111744,32266,64631,14847,79478
Georgia,Oconee,13219,40280,11680,22236,6364,28600
Georgia,Oglethorpe,13221,15259,3480,8821,2958,11779
Georgia,Paulding,13223,168667,47876,102402,18389,120791
Georgia,Peach,13225,27546,7111,15889,4546,20435
Georgia,Pickens,13227,32591,7090,18219,7282,25501
Georgia,Pierce,13229,19465,5212,10858,3395,14253
Georgia,Pike,13231,18962,4837,11058,3067,14125
Georgia,Polk,13233,42613,11780,24138,6695,30833
Georgia,Pulaski,13235,11137,2210,6377,2550,8927
Georgia,Putnam,13237,22119,4752,11871,5496,17367
Georgia,Quitman,13239,2299,482,1112,705,1817
Georgia,Rabun,13241,17137,3153,9165,4819,13984
Georgia,Randolph,13243,6778,1589,3512,1677,5189
Georgia,Richmond,13245,202518,52656,120499,29363,149862
Georgia,Rockdale,13247,90896,24507,52815,13574,66389
Georgia,Schley,13249,5257,1402,2917,938,3855
Georgia,Screven,13251,13966,3229,8007,2730,10737
Georgia,Seminole,13253,8090,1842,4372,1876,6248
Georgia,Spalding,13255,66703,17119,37406,12178,49584
Georgia,Stephens,13257,25925,6567,14237,5121,19358
Georgia,Stewart,13259,6621,854,4771,996,5767
Georgia,Sumter,13261,29524,7844,16506,5174,21680
Georgia,Talbot,13263,6195,1126,3492,1577,5069
Georgia,Taliaferro,13265,1537,278,828,431,1259
Georgia,Tattnall,13267,25286,5681,15802,3803,19605
Georgia,Taylor,13269,8020,1767,4576,1677,6253
Georgia,Telfair,13271,15860,2864,10020,2976,12996
Georgia,Terrell,13273,8531,2152,4666,1713,6379
Georgia,Thomas,13275,44451,11507,24640,8304,32944
Georgia,Tift,13277,40644,11596,22789,6259,29048
Georgia,Toombs,13279,26830,7718,14563,4549,19112
Georgia,Towns,13281,12037,2359,5472,4206,9678
Georgia,Treutlen,13283,6901,1750,3862,1289,5151
Georgia,Troup,13285,69922,18865,40419,10638,51057
Georgia,Turner,13287,7985,2149,4240,1596,5836
Georgia,Twiggs,13289,8120,1706,4519,1895,6414
Georgia,Union,13291,24511,4201,12047,8263,20310
Georgia,Upson,13293,26320,6523,14915,4882,19797
Georgia,Walker,13295,69761,16451,40111,13199,53310
Georgia,Walton,13297,94593,25364,54361,14868,69229
Georgia,Ware,13299,35734,9442,20020,6272,26292
Georgia,Warren,13301,5254,1142,2896,1216,4112
Georgia,Washington,13303,20374,4831,11916,3627,15543
Georgia,Wayne,13305,29927,7901,17243,4783,22026
Georgia,Webster,13307,2607,547,1441,619,2060
Georgia,Wheeler,13309,7855,1491,5205,1159,6364
Georgia,White,13311,30798,6921,16686,7191,23877
Georgia,Whitfield,13313,104628,29738,59845,15045,74890
Georgia,Wilcox,13315,8635,1792,5274,1569,6843
Georgia,Wilkes,13317,9777,2269,5188,2320,7508
Georgia,Wilkinson,13319,8954,2224,4922,1808,6730
Georgia,Worth,13321,20247,4894,11329,4024,15353
Hawaii,Hawaii,15001,201513,47311,110161,44041,154202
Hawaii,Honolulu,15003,974563,226372,570523,177668,748191
Hawaii,Kauai,15007,72293,17030,40312,14951,55263
Hawaii,Maui,15009,167417,39379,96289,31749,128038
Idaho,Ada,16001,481587,124138,285491,71958,357449
Idaho,Adams,16003,4294,798,2212,1284,3496
Idaho,Bannock,16005,87808,25451,49463,12894,62357
Idaho,Bear Lake,16007,6125,1785,3075,1265,4340
Idaho,Benewah,16009,9298,2241,4939,2118,7057
Idaho,Bingham,16011,46811,15513,24510,6788,31298
Idaho,Blaine,16013,23021,5385,12953,4683,17636
Idaho,Boise,16015,7831,1412,4361,2058,6419
Idaho,Bonner,16017,45739,9814,24311,11614,35925
Idaho,Bonneville,16019,119062,39024,63926,16112,80038
Idaho,Boundary,16021,12245,3107,6313,2825,9138
Idaho,Butte,16023,2597,680,1303,614,1917
Idaho,Camas,16025,1106,263,573,270,843
Idaho,Canyon,16027,229849,70632,127004,32213,159217
Idaho,Caribou,16029,7155,2251,3663,1241,4904
Idaho,Cassia,16031,24030,8300,12257,3473,15730
Idaho,Clark,16033,845,217,464,164,628
Idaho,Clearwater,16035,8756,1514,4791,2451,7242
Idaho,Custer,16037,4315,814,2203,1298,3501
Idaho,Elmore,16039,27511,7588,16043,3880,19923
Idaho,Franklin,16041,13876,4786,7061,2029,9090
Idaho,Fremont,16043,13099,3587,7226,2286,9512
Idaho,Gem,16045,18112,4494,9632,3986,13618
Idaho,Gooding,16047,15179,4471,7996,2712,10708
Idaho,Idaho,16049,16667,3544,8350,4773,13123
Idaho,Jefferson,16051,29871,10878,15538,3455,18993
Idaho,Jerome,16053,24412,8056,13124,3232,16356
Idaho,Kootenai,16055,165697,40982,92522,32193,124715
Idaho,Latah,16057,40108,9826,24632,5650,30282
Idaho,Lemhi,16059,8027,1641,3927,2459,6386
Idaho,Lewis,16061,3838,906,1901,1031,2932
Idaho,Lincoln,16063,5366,1621,2986,759,3745
Idaho,Madison,16065,39907,13688,23390,2829,26219
Idaho,Minidoka,16067,21039,6535,11087,3417,14504
Idaho,Nez Perce,16069,40408,9577,22663,8168,30831
Idaho,Oneida,16071,4531,1398,2207,926,3133
Idaho,Owyhee,16073,11823,3313,6376,2134,8510
Idaho,Payette,16075,23951,6762,12728,4461,17189
Idaho,Power,16077,7681,2557,3921,1203,5124
Idaho,Shoshone,16079,12882,2875,7026,2981,10007
Idaho,Teton,16081,12142,3118,7428,1596,9024
Idaho,Twin Falls,16083,86878,25879,47410,13589,60999
Idaho,Valley,16085,11392,2236,6201,2955,9156
Idaho,Washington,16087,10194,2516,5035,2643,7678
Illinois,Adams,17001,65435,16190,35732,13513,49245
Illinois,Alexander,17003,5761,1383,3046,1332,4378
Illinois,Bond,17005,16426,3470,9762,3194,12956
Illinois,Boone,17007,53544,14645,30257,8642,38899
Illinois,Brown,17009,6578,1191,4462,925,5387
Illinois,Bureau,17011,32628,7573,17716,7339,25055
Illinois,Calhoun,17013,4739,1040,2556,1143,3699
Illinois,Carroll,17015,14305,3053,7561,3691,11252
Illinois,Cass,17017,12147,3222,6707,2218,8925
Illinois,Champaign,17019,209689,53557,128305,27827,156132
Illinois,Christian,17021,32304,7133,18639,6532,25171
Illinois,Clark,17023,15441,3773,8553,3115,11668
Illinois,Clay,17025,13184,3238,7208,2738,9946
Illinois,Clinton,17027,37562,8666,22151,6745,28896
Illinois,Coles,17029,50621,11433,30340,8848,39188
Illinois,Cook,17031,5150233,1234271,3139733,776229,3915962
Illinois,Crawford,17033,18667,4063,10982,3622,14604
Illinois,Cumberland,17035,10766,2599,5969,2198,8167
Illinois,DeKalb,17037,104897,27800,63545,13552,77097
Illinois,De Witt,17039,15638,3630,8916,3092,12008
Illinois,Douglas,17041,19465,5262,10635,3568,14203
Illinois,DuPage,17043,922921,230146,543777,148998,692775
Illinois,Edgar,17045,17161,3804,9490,3867,13357
Illinois,Edwards,17047,6395,1564,3432,1399,4831
Illinois,Effingham,17049,34008,8790,19131,6087,25218
Illinois,Fayette,17051,21336,4898,12302,4136,16438
Illinois,Ford,17053,12961,3243,7222,2496,9718
Illinois,Franklin,17055,38469,9247,21198,8024,29222
Illinois,Fulton,17057,34340,7392,19670,7278,26948
Illinois,Gallatin,17059,4828,1057,2592,1179,3771
Illinois,Greene,17061,12969,3018,7353,2598,9951
Illinois,Grundy,17063,51054,13981,29633,7440,37073
Illinois,Hamilton,17065,8116,1933,4367,1816,6183
Illinois,Hancock,17067,17708,4044,9495,4169,13664
Illinois,Hardin,17069,3821,742,2058,1021,3079
Illinois,Henderson,17071,6646,1341,3618,1687,5305
Illinois,Henry,17073,48913,11861,26835,10217,37052
Illinois,Iroquois,17075,27114,6433,14714,5967,20681
Illinois,Jackson,17077,56750,13278,34232,9240,43472
Illinois,Jasper,17079,9610,2439,5271,1900,7171
Illinois,Jefferson,17081,37684,9154,21198,7332,28530
Illinois,Jersey,17083,21773,5003,12453,4317,16770
Illinois,Jo Daviess,17085,21235,4372,10738,6125,16863
Illinois,Johnson,17087,12417,2572,7127,2718,9845
Illinois,Kane,17089,532403,147225,309237,75941,385178
Illinois,Kankakee,17091,109862,28448,62383,19031,81414
Illinois,Kendall,17093,128990,39625,75541,13824,89365
Illinois,Knox,17095,49699,11323,27472,10904,38376
Illinois,Lake,17097,696535,187898,405436,103201,508637
Illinois,LaSalle,17099,108669,25523,62113,21033,83146
Illinois,Lawrence,17101,15678,3267,9611,2800,12411
Illinois,Lee,17103,34096,7364,19854,6878,26732
Illinois,Livingston,17105,35648,8472,20263,6913,27176
Illinois,Logan,17107,28618,6361,16926,5331,22257
Illinois,McDonough,17109,29682,7066,17229,5387,22616
Illinois,McHenry,17111,307774,78717,182157,46900,229057
Illinois,McLean,17113,171517,44890,103005,23622,126627
Illinois,Macon,17115,104009,25757,57057,21195,78252
Illinois,Macoupin,17117,44926,10461,25320,9145,34465
Illinois,Madison,17119,262966,63157,153475,46334,199809
Illinois,Marion,17121,37205,9351,20488,7366,27854
Illinois,Marshall,17123,11438,2526,6212,2700,8912
Illinois,Mason,17125,13359,3035,7330,2994,10324
Illinois,Massac,17127,13772,3250,7574,2948,10522
Illinois,Menard,17129,12196,2880,6874,2442,9316
Illinois,Mercer,17131,15437,3583,8489,3365,11854
Illinois,Monroe,17133,34637,8332,19945,6360,26305
Illinois,Montgomery,17135,28414,6261,16300,5853,22153
Illinois,Morgan,17137,33658,7422,19433,6803,26236
Illinois,Moultrie,17139,14501,3981,7707,2813,10520
Illinois,Ogle,17141,50643,12438,28494,9711,38205
Illinois,Peoria,17143,179179,47147,100543,31489,132032
Illinois,Perry,17145,20916,4541,12368,4007,16375
Illinois,Piatt,17147,16344,3959,9145,3240,12385
Illinois,Pike,17149,15561,3830,8419,3312,11731
Illinois,Pope,17151,4177,630,2364,1183,3547
Illinois,Pulaski,17153,5335,1254,2846,1235,4081
Illinois,Putnam,17155,5739,1274,3136,1329,4465
Illinois,Randolph,17157,31782,6663,18962,6157,25119
Illinois,Richland,17159,15513,3791,8452,3270,11722
Illinois,Rock Island,17161,141879,35140,78693,28046,106739
Illinois,St. Clair,17163,259686,66379,150710,42597,193307
Illinois,Saline,17165,23491,5508,13170,4813,17983
Illinois,Sangamon,17167,194672,47425,111414,35833,147247
Illinois,Schuyler,17169,6768,1355,3827,1586,5413
Illinois,Scott,17171,4951,1154,2825,972,3797
Illinois,Shelby,17173,21634,4985,11635,5014,16649
Illinois,Stark,17175,5342,1268,2858,1216,4074
Illinois,Stephenson,17177,44498,10356,23716,10426,34142
Illinois,Tazewell,17179,131803,32353,73993,25457,99450
Illinois,Union,17181,16653,3844,9166,3643,12809
Illinois,Vermilion,17183,75758,19393,41337,15028,56365
Illinois,Wabash,17185,11520,2784,6273,2463,8736
Illinois,Warren,17187,16844,4366,9080,3398,12478
Illinois,Washington,17189,13887,3209,7799,2879,10678
Illinois,Wayne,17191,16215,3961,8650,3604,12254
Illinois,White,17193,13537,3254,7390,2893,10283
Illinois,Whiteside,17195,55175,13287,30156,11732,41888
Illinois,Will,17197,690743,187726,409426,93591,503017
Illinois,Williamson,17199,66597,15674,37961,12962,50923
Illinois,Winnebago,17201,282572,72454,159301,50817,210118
Illinois,Woodford,17203,38459,10228,21059,7172,28231
Indiana,Adams,18001,35777,12098,17998,5681,23679
Indiana,Allen,18003,379299,106489,216226,56584,272810
Indiana,Bartholomew,18005,83779,21568,48360,13851,62211
Indiana,Benton,18007,8748,2389,4788,1571,6359
Indiana,Blackford,18009,11758,2767,6417,2574,8991
Indiana,Boone,18011,67843,19125,39376,9342,48718
Indiana,Brown,18013,15092,2880,8379,3833,12212
Indiana,Carroll,18015,20257,4887,11310,4060,15370
Indiana,Cass,18017,37689,9500,21300,6889,28189
Indiana,Clark,18019,118302,28809,70376,19117,89493
Indiana,Clay,18021,26225,6529,14917,4779,19696
Indiana,Clinton,18023,32399,9257,17702,5440,23142
Indiana,Crawford,18025,10577,2500,5953,2124,8077
Indiana,Daviess,18027,33351,10651,17553,5147,22700
Indiana,Dearborn,18029,49458,11976,28418,9064,37482
Indiana,Decatur,18031,26559,6926,15004,4629,19633
Indiana,DeKalb,18033,43475,11396,24879,7200,32079
Indiana,Delaware,18035,114135,27008,67200,19927,87127
Indiana,Dubois,18037,42736,11384,23718,7634,31352
Indiana,Elkhart,18039,206341,61810,113321,31210,144531
Indiana,Fayette,18041,23102,5527,12835,4740,17575
Indiana,Floyd,18043,78522,19497,46098,12927,59025
Indiana,Fountain,18045,16346,3898,9130,3318,12448
Indiana,Franklin,18047,22758,5745,12695,4318,17013
Indiana,Fulton,18049,19974,5120,10878,3976,14854
Indiana,Gibson,18051,33659,8721,18957,5981,24938
Indiana,Grant,18053,65769,16282,36704,12783,49487
Indiana,Greene,18055,31922,7588,18002,6332,24334
Indiana,Hamilton,18057,338011,97843,196857,43311,240168
Indiana,Hancock,18059,78168,19950,45343,12875,58218
Indiana,Harrison,18061,40515,9825,23354,7336,30690
Indiana,Hendricks,18063,170311,46030,100084,24197,124281
Indiana,Henry,18065,47972,10781,27927,9264,37191
Indiana,Howard,18067,82544,20444,45685,16415,62100
Indiana,Huntington,18069,36520,8903,21223,6394,27617
Indiana,Jackson,18071,44231,11795,25072,7364,32436
Indiana,Jasper,18073,33562,8701,18778,6083,24861
Indiana,Jay,18075,20436,5621,11040,3775,14815
Indiana,Jefferson,18077,32308,7550,18828,5930,24758
Indiana,Jennings,18079,27735,7009,16051,4675,20726
Indiana,Johnson,18081,158167,42519,92168,23480,115648
Indiana,Knox,18083,36594,9310,20548,6736,27284
Indiana,Kosciusko,18085,79456,20836,44899,13721,58620
Indiana,LaGrange,18087,39614,13927,20198,5489,25687
Indiana,Lake,18089,485493,124744,278554,82195,360749
Indiana,LaPorte,18091,109888,25609,63976,20303,84279
Indiana,Lawrence,18093,45370,10618,25410,9342,34752
Indiana,Madison,18095,129569,30860,74512,24197,98709
Indiana,Marion,18097,964582,260603,579759,124220,703979
Indiana,Marshall,18099,46258,12694,25109,8455,33564
Indiana,Martin,18101,10255,2472,5669,2114,7783
Indiana,Miami,18103,35516,8316,20801,6399,27200
Indiana,Monroe,18105,148431,34560,93757,20114,113871
Indiana,Montgomery,18107,38338,9767,21551,7020,28571
Indiana,Morgan,18109,70489,17400,40888,12201,53089
Indiana,Newton,18111,13984,3213,7953,2818,10771
Indiana,Noble,18113,47744,12726,27133,7885,35018
Indiana,Ohio,18115,5875,1259,3299,1317,4616
Indiana,Orange,18117,19646,4937,10819,3890,14709
Indiana,Owen,18119,20799,4753,11901,4145,16046
Indiana,Parke,18121,16937,3968,9589,3380,12969
Indiana,Perry,18123,19169,4416,11115,3638,14753
Indiana,Pike,18125,12389,2950,6898,2541,9439
Indiana,Porter,18127,170389,41698,99939,28752,128691
Indiana,Posey,18129,25427,6024,14400,5003,19403
Indiana,Pulaski,18131,12353,2995,6877,2481,9358
Indiana,Putnam,18133,37576,8803,22362,6411,28773
Indiana,Randolph,18135,24665,6129,13402,5134,18536
Indiana,Ripley,18137,28324,7275,15864,5185,21049
Indiana,Rush,18139,16581,4107,9366,3108,12474
Indiana,St. Joseph,18141,271826,72985,154881,43960,198841
Indiana,Scott,18143,23873,5850,13949,4074,18023
Indiana,Shelby,18145,44729,11070,25830,7829,33659
Indiana,Spencer,18147,20277,4833,11392,4052,15444
Indiana,Starke,18149,22995,5672,12950,4373,17323
Indiana,Steuben,18151,34594,8112,19228,7254,26482
Indiana,Sullivan,18153,20669,4390,12459,3820,16279
Indiana,Switzerland,18155,10751,2872,6009,1870,7879
Indiana,Tippecanoe,18157,195732,52944,119508,23280,142788
Indiana,Tipton,18159,15148,3413,8496,3239,11735
Indiana,Union,18161,7054,1617,4047,1390,5437
Indiana,Vanderburgh,18163,181451,44254,105707,31490,137197
Indiana,Vermillion,18165,15498,3779,8571,3148,11719
Indiana,Vigo,18167,107038,25981,63181,17876,81057
Indiana,Wabash,18169,30996,7419,16990,6587,23577
Indiana,Warren,18171,8265,2007,4557,1701,6258
Indiana,Warrick,18173,62998,16195,35530,11273,46803
Indiana,Washington,18175,28036,7044,16131,4861,20992
Indiana,Wayne,18177,65884,16167,36843,12874,49717
Indiana,Wells,18179,28296,7561,15465,5270,20735
Indiana,White,18181,24102,6164,13038,4900,17938
Indiana,Whitley,18183,33964,8474,19192,6298,25490
Iowa,Adair,19001,7152,1697,3807,1648,5455
Iowa,Adams,19003,3602,814,1936,852,2788
Iowa,Allamakee,19005,13687,3465,7010,3212,10222
Iowa,Appanoose,19007,12426,3046,6537,2843,9380
Iowa,Audubon,19009,5496,1249,2889,1358,4247
Iowa,Benton,19011,25645,6478,14282,4885,19167
Iowa,Black Hawk,19013,131228,32823,76162,22243,98405
Iowa,Boone,19015,26234,6049,15198,4987,20185
Iowa,Bremer,19017,25062,6635,13450,4977,18427
Iowa,Buchanan,19019,21175,5964,11344,3867,15211
Iowa,Buena Vista,19021,19620,5679,10670,3271,13941
Iowa,Butler,19023,14439,3496,7642,3301,10943
Iowa,Calhoun,19025,9668,2255,5141,2272,7413
Iowa,Carroll,19027,20165,5356,10638,4171,14809
Iowa,Cass,19029,12836,3102,6712,3022,9734
Iowa,Cedar,19031,18627,4477,10362,3788,14150
Iowa,Cerro Gordo,19033,42450,9798,23168,9484,32652
Iowa,Cherokee,19035,11235,2621,5844,2770,8614
Iowa,Chickasaw,19037,11933,3064,6344,2525,8869
Iowa,Clarke,19039,9395,2609,4979,1807,6786
Iowa,Clay,19041,16016,3957,8673,3386,12059
Iowa,Clayton,19043,17549,4027,9248,4274,13522
Iowa,Clinton,19045,46429,11536,25641,9252,34893
Iowa,Crawford,19047,16820,4708,9093,3019,12112
Iowa,Dallas,19049,93453,27521,54581,11351,65932
Iowa,Davis,19051,9000,2856,4547,1597,6144
Iowa,Decatur,19053,7870,2155,4114,1601,5715
Iowa,Delaware,19055,17011,4370,9275,3366,12641
Iowa,Des Moines,19057,38967,9562,21141,8264,29405
Iowa,Dickinson,19059,17258,3592,9054,4612,13666
Iowa,Dubuque,19061,97311,25119,54373,17819,72192
Iowa,Emmet,19063,9208,2169,5050,1989,7039
Iowa,Fayette,19065,19650,4764,10664,4222,14886
Iowa,Floyd,19067,15642,3894,8270,3478,11748
Iowa,Franklin,19069,10070,2560,5358,2152,7510
Iowa,Fremont,19071,6960,1652,3679,1629,5308
Iowa,Greene,19073,8888,2219,4666,2003,6669
Iowa,Grundy,19075,12232,3038,6599,2595,9194
Iowa,Guthrie,19077,10689,2564,5690,2435,8125
Iowa,Hamilton,19079,14773,3675,8001,3097,11098
Iowa,Hancock,19081,10630,2567,5643,2420,8063
Iowa,Hardin,19083,16846,3813,9232,3801,13033
Iowa,Harrison,19085,14049,3527,7732,2790,10522
Iowa,Henry,19087,19954,4859,11203,3892,15095
Iowa,Howard,19089,9158,2464,4783,1911,6694
Iowa,Humboldt,19091,9558,2414,5028,2116,7144
Iowa,Ida,19093,6860,1833,3516,1511,5027
Iowa,Iowa,19095,16184,4084,8974,3126,12100
Iowa,Jackson,19097,19439,4723,10576,4140,14716
Iowa,Jasper,19099,37185,8991,20945,7249,28194
Iowa,Jefferson,19101,18295,3114,10842,4339,15181
Iowa,Johnson,19103,151140,37884,94691,18565,113256
Iowa,Jones,19105,20681,4751,11555,4375,15930
Iowa,Keokuk,19107,10246,2565,5422,2259,7681
Iowa,Kossuth,19109,14813,3544,7659,3610,11269
Iowa,Lee,19111,33657,7790,18810,7057,25867
Iowa,Linn,19113,226706,57949,131904,36853,168757
Iowa,Louisa,19115,11035,2658,6240,2137,8377
Iowa,Lucas,19117,8600,2151,4526,1923,6449
Iowa,Lyon,19119,11755,3575,6021,2159,8180
Iowa,Madison,19121,16338,4371,9087,2880,11967
Iowa,Mahaska,19123,22095,5932,12067,4096,16163
Iowa,Marion,19125,33253,8891,18234,6128,24362
Iowa,Marshall,19127,39369,10928,21162,7279,28441
Iowa,Mills,19129,15109,3833,8420,2856,11276
Iowa,Mitchell,19131,10586,2748,5573,2265,7838
Iowa,Monona,19133,8615,2054,4432,2129,6561
Iowa,Monroe,19135,7707,1935,4208,1564,5772
Iowa,Montgomery,19137,9917,2447,5323,2147,7470
Iowa,Muscatine,19139,42664,11570,23753,7341,31094
Iowa,O'Brien,19141,13753,3604,7309,2840,10149
Iowa,Osceola,19143,5958,1495,3111,1352,4463
Iowa,Page,19145,15107,3081,8538,3488,12026
Iowa,Palo Alto,19147,8886,2278,4643,1965,6608
Iowa,Plymouth,19149,25177,6878,13633,4666,18299
Iowa,Pocahontas,19151,6619,1624,3444,1551,4995
Iowa,Polk,19153,490161,132625,291445,66091,357536
Iowa,Pottawattamie,19155,93206,24266,52208,16732,68940
Iowa,Poweshiek,19157,18504,4515,10035,3954,13989
Iowa,Ringgold,19159,4894,1236,2444,1214,3658
Iowa,Sac,19161,9721,2387,5012,2322,7334
Iowa,Scott,19163,172943,44903,99154,28886,128040
Iowa,Shelby,19165,11454,2823,5986,2645,8631
Iowa,Sioux,19167,34855,10887,18300,5668,23968
Iowa,Story,19169,97117,24362,60486,12269,72755
Iowa,Tama,19171,16854,4453,9045,3356,12401
Iowa,Taylor,19173,6121,1571,3158,1392,4550
Iowa,Union,19175,12241,3120,6548,2573,9121
Iowa,Van Buren,19177,7044,1752,3706,1586,5292
Iowa,Wapello,19179,34969,8838,19708,6423,26131
Iowa,Warren,19181,51466,14212,29014,8240,37254
Iowa,Washington,19183,21965,5870,11711,4384,16095
Iowa,Wayne,19185,6441,1745,3245,1451,4696
Iowa,Webster,19187,35904,9075,20070,6759,26829
Iowa,Winnebago,19189,10354,2603,5469,2282,7751
Iowa,Winneshiek,19191,19991,4780,10994,4217,15211
Iowa,Woodbury,19193,103107,29774,57476,15857,73333
Iowa,Worth,19195,7381,1674,4162,1545,5707
Iowa,Wright,19197,12562,3324,6334,2904,9238
Kansas,Allen,20001,12369,3167,6608,2594,9202
Kansas,Anderson,20003,7858,2176,3995,1687,5682
Kansas,Atchison,20005,16073,4491,8753,2829,11582
Kansas,Barber,20007,4427,1106,2299,1022,3321
Kansas,Barton,20009,25779,6765,13882,5132,19014
Kansas,Bourbon,20011,14534,4154,7440,2940,10380
Kansas,Brown,20013,9564,2625,4956,1983,6939
Kansas,Butler,20015,66911,18855,37554,10502,48056
Kansas,Chase,20017,2648,575,1386,687,2073
Kansas,Chautauqua,20019,3250,703,1644,903,2547
Kansas,Cherokee,20021,19939,4978,11031,3930,14961
Kansas,Cheyenne,20023,2657,614,1317,726,2043
Kansas,Clark,20025,1994,534,1032,428,1460
Kansas,Clay,20027,8002,2017,4105,1880,5985
Kansas,Cloud,20029,8786,2361,4529,1896,6425
Kansas,Coffey,20031,8179,1954,4431,1794,6225
Kansas,Comanche,20033,1700,448,818,434,1252
Kansas,Cowley,20035,34908,9372,18976,6560,25536
Kansas,Crawford,20037,38818,10187,22496,6135,28631
Kansas,Decatur,20039,2827,610,1414,803,2217
Kansas,Dickinson,20041,18466,4684,10034,3748,13782
Kansas,Doniphan,20043,7600,1957,4140,1503,5643
Kansas,Douglas,20045,122259,29138,77443,15678,93121
Kansas,Edwards,20047,2798,721,1471,606,2077
Kansas,Elk,20049,2530,618,1180,732,1912
Kansas,Ellis,20051,28553,7217,16765,4571,21336
Kansas,Ellsworth,20053,6102,1219,3584,1299,4883
Kansas,Finney,20055,36467,12232,20094,4141,24235
Kansas,Ford,20057,33619,11107,18703,3809,22512
Kansas,Franklin,20059,25544,6761,14437,4346,18783
Kansas,Geary,20061,31670,10397,18415,2858,21273
Kansas,Gove,20063,2636,689,1308,639,1947
Kansas,Graham,20065,2482,544,1243,695,1938
Kansas,Grant,20067,7150,2361,3747,1042,4789
Kansas,Gray,20069,5988,1877,3182,929,4111
Kansas,Greeley,20071,1232,356,633,243,876
Kansas,Greenwood,20073,5982,1421,3044,1517,4561
Kansas,Hamilton,20075,2539,797,1374,368,1742
Kansas,Harper,20077,5436,1453,2706,1277,3983
Kansas,Harvey,20079,34429,9336,18271,6822,25093
Kansas,Haskell,20081,3968,1220,2128,620,2748
Kansas,Hodgeman,20083,1794,452,904,438,1342
Kansas,Jackson,20085,13171,3617,6997,2557,9554
Kansas,Jefferson,20087,19043,4722,10727,3594,14321
Kansas,Jewell,20089,2879,627,1381,871,2252
Kansas,Johnson,20091,602401,158201,353657,90543,444200
Kansas,Kearny,20093,3838,1185,2021,632,2653
Kansas,Kingman,20095,7152,1741,3869,1542,5411
Kansas,Kiowa,20097,2475,670,1243,562,1805
Kansas,Labette,20099,19618,5115,10678,3825,14503
Kansas,Lane,20101,1535,367,807,361,1168
Kansas,Leavenworth,20103,81758,20834,48628,12296,60924
Kansas,Lincoln,20105,2962,710,1499,753,2252
Kansas,Linn,20107,9703,2331,5135,2237,7372
Kansas,Logan,20109,2794,724,1479,591,2070
Kansas,Lyon,20111,33195,8791,19214,5190,24404
Kansas,McPherson,20113,28542,7250,15528,5764,21292
Kansas,Marion,20115,11884,2883,6169,2832,9001
Kansas,Marshall,20117,9707,2547,5012,2148,7160
Kansas,Meade,20119,4033,1117,2128,788,2916
Kansas,Miami,20121,34237,9153,19243,5841,25084
Kansas,Mitchell,20123,5979,1572,2963,1444,4407
Kansas,Montgomery,20125,31829,8639,16727,6463,23190
Kansas,Morris,20127,5620,1269,2978,1373,4351
Kansas,Morton,20129,2587,694,1327,566,1893
Kansas,Nemaha,20131,10231,2986,5198,2047,7245
Kansas,Neosho,20133,16007,4358,8414,3235,11649
Kansas,Ness,20135,2750,629,1382,739,2121
Kansas,Norton,20137,5361,1098,3123,1140,4263
Kansas,Osage,20139,15949,4030,8640,3279,11919
Kansas,Osborne,20141,3421,788,1779,854,2633
Kansas,Ottawa,20143,5704,1392,3099,1213,4312
Kansas,Pawnee,20145,6414,1223,3811,1380,5191
Kansas,Phillips,20147,5234,1288,2648,1298,3946
Kansas,Pottawatomie,20149,24383,7643,13175,3565,16740
Kansas,Pratt,20151,9164,2494,4727,1943,6670
Kansas,Rawlins,20153,2530,586,1237,707,1944
Kansas,Reno,20155,61998,15415,34019,12564,46583
Kansas,Republic,20157,4636,1078,2269,1289,3558
Kansas,Rice,20159,9537,2545,5118,1874,6992
Kansas,Riley,20161,74232,17804,49146,7282,56428
Kansas,Rooks,20163,4920,1175,2608,1137,3745
Kansas,Rush,20165,3036,685,1579,772,2351
Kansas,Russell,20167,6856,1607,3555,1694,5249
Kansas,Saline,20169,54224,13957,30324,9943,40267
Kansas,Scott,20171,4823,1382,2469,972,3441
Kansas,Sedgwick,20173,516042,143981,295028,77033,372061
Kansas,Seward,20175,21428,7585,11681,2162,13843
Kansas,Shawnee,20177,176875,45436,98122,33317,131439
Kansas,Sheridan,20179,2521,666,1257,598,1855
Kansas,Sherman,20181,5917,1620,3145,1152,4297
Kansas,Smith,20183,3583,819,1762,1002,2764
Kansas,Stafford,20185,4156,1071,2126,959,3085
Kansas,Stanton,20187,2006,622,1037,347,1384
Kansas,Stevens,20189,5485,1694,2876,915,3791
Kansas,Sumner,20191,22836,6052,12401,4383,16784
Kansas,Thomas,20193,7777,2177,4195,1405,5600
Kansas,Trego,20195,2803,541,1498,764,2262
Kansas,Wabaunsee,20197,6931,1753,3728,1450,5178
Kansas,Wallace,20199,1518,410,740,368,1108
Kansas,Washington,20201,5406,1323,2789,1294,4083
Kansas,Wichita,20203,2119,621,1069,429,1498
Kansas,Wilson,20205,8525,2235,4412,1878,6290
Kansas,Woodson,20207,3138,734,1614,790,2404
Kansas,Wyandotte,20209,165429,49580,95054,20795,115849
Kentucky,Adair,21001,19202,4603,10904,3695,14599
Kentucky,Allen,21003,21315,5372,12092,3851,15943
Kentucky,Anderson,21005,22747,5831,13206,3710,16916
Kentucky,Ballard,21007,7888,1833,4328,1727,6055
Kentucky,Barren,21009,44249,11300,24980,7969,32949
Kentucky,Bath,21011,12500,3463,6913,2124,9037
Kentucky,Bell,21013,26032,6033,14865,5134,19999
Kentucky,Boone,21015,133581,37643,77135,18803,95938
Kentucky,Bourbon,21017,19788,4867,11024,3897,14921
Kentucky,Boyd,21019,46718,10790,26594,9334,35928
Kentucky,Boyle,21021,30060,7080,17088,5892,22980
Kentucky,Bracken,21023,8303,2127,4748,1428,6176
Kentucky,Breathitt,21025,12630,2847,7544,2239,9783
Kentucky,Breckinridge,21027,20477,5044,11386,4047,15433
Kentucky,Bullitt,21029,81676,19339,49121,13216,62337
Kentucky,Butler,21031,12879,3156,7297,2426,9723
Kentucky,Caldwell,21033,12747,3121,6907,2719,9626
Kentucky,Calloway,21035,39001,9070,23119,6812,29931
Kentucky,Campbell,21037,93584,22205,56311,15068,71379
Kentucky,Carlisle,21039,4760,1200,2532,1028,3560
Kentucky,Carroll,21041,10631,2981,5982,1668,7650
Kentucky,Carter,21043,26797,6625,14966,5206,20172
Kentucky,Casey,21045,16159,4021,8845,3293,12138
Kentucky,Christian,21047,70461,21156,40322,8983,49305
Kentucky,Clark,21049,36263,8782,20872,6609,27481
Kentucky,Clay,21051,19901,4565,12237,3099,15336
Kentucky,Clinton,21053,10218,2465,5735,2018,7753
Kentucky,Crittenden,21055,8806,2115,4811,1880,6691
Kentucky,Cumberland,21057,6614,1506,3601,1507,5108
Kentucky,Daviess,21059,101511,26995,56969,17547,74516
Kentucky,Edmonson,21061,12150,2479,7070,2601,9671
Kentucky,Elliott,21063,7517,1465,4522,1530,6052
Kentucky,Estill,21065,14106,3284,8110,2712,10822
Kentucky,Fayette,21067,323152,78757,199575,44820,244395
Kentucky,Fleming,21069,14581,3882,8075,2624,10699
Kentucky,Floyd,21071,35589,8571,20312,6706,27018
Kentucky,Franklin,21073,50991,12056,29554,9381,38935
Kentucky,Fulton,21075,5969,1379,3352,1238,4590
Kentucky,Gallatin,21077,8869,2325,5287,1257,6544
Kentucky,Garrard,21079,17666,4246,10178,3242,13420
Kentucky,Grant,21081,25069,7177,14372,3520,17892
Kentucky,Graves,21083,37266,9749,20493,7024,27517
Kentucky,Grayson,21085,26427,6715,14931,4781,19712
Kentucky,Green,21087,10941,2461,6173,2307,8480
Kentucky,Greenup,21089,35098,8183,19446,7469,26915
Kentucky,Hancock,21091,8722,2382,4799,1541,6340
Kentucky,Hardin,21093,110958,29831,65100,16027,81127
Kentucky,Harlan,21095,26010,6442,14570,4998,19568
Kentucky,Harrison,21097,18886,4696,10781,3409,14190
Kentucky,Hart,21099,19035,5095,10754,3186,13940
Kentucky,Henderson,21101,45210,11231,25719,8260,33979
Kentucky,Henry,21103,16126,4119,9102,2905,12007
Kentucky,Hickman,21105,4380,897,2327,1156,3483
Kentucky,Hopkins,21107,44686,11040,25152,8494,33646
Kentucky,Jackson,21109,13329,3279,7644,2406,10050
Kentucky,Jefferson,21111,766757,186730,452286,127741,580027
Kentucky,Jessamine,21113,54115,14357,31357,8401,39758
Kentucky,Johnson,21115,22188,5418,12610,4160,16770
Kentucky,Kenton,21117,166998,42966,99185,24847,124032
Kentucky,Knott,21119,14806,3429,8544,2833,11377
Kentucky,Knox,21121,31145,7980,17642,5523,23165
Kentucky,Larue,21123,14398,3568,8257,2573,10830
Kentucky,Laurel,21125,60813,15320,35328,10165,45493
Kentucky,Lawrence,21127,15317,3952,8605,2760,11365
Kentucky,Lee,21129,7403,1481,4648,1274,5922
Kentucky,Leslie,21131,9877,2296,5735,1846,7581
Kentucky,Letcher,21133,21553,5066,12199,4288,16487
Kentucky,Lewis,21135,13275,3187,7631,2457,10088
Kentucky,Lincoln,21137,24549,6312,13621,4616,18237
Kentucky,Livingston,21139,9194,2028,5098,2068,7166
Kentucky,Logan,21141,27102,6927,15124,5051,20175
Kentucky,Lyon,21143,8210,1301,4771,2138,6909
Kentucky,McCracken,21145,65418,15797,36313,13308,49621
Kentucky,McCreary,21147,17231,4129,10300,2802,13102
Kentucky,McLean,21149,9207,2379,4990,1838,6828
Kentucky,Madison,21151,92987,24005,55788,13194,68982
Kentucky,Magoffin,21153,12161,2975,7024,2162,9186
Kentucky,Marion,21155,19273,5042,10966,3265,14231
Kentucky,Marshall,21157,31100,6962,17252,6886,24138
Kentucky,Martin,21159,11195,2387,6896,1912,8808
Kentucky,Mason,21161,17070,4322,9558,3190,12748
Kentucky,Meade,21163,28572,6959,17426,4187,21613
Kentucky,Menifee,21165,6489,1359,3739,1391,5130
Kentucky,Mercer,21167,21933,5286,12505,4142,16647
Kentucky,Metcalfe,21169,10071,2535,5582,1954,7536
Kentucky,Monroe,21171,10650,2640,5962,2048,8010
Kentucky,Montgomery,21173,28157,7157,16404,4596,21000
Kentucky,Morgan,21175,13309,2594,8399,2316,10715
Kentucky,Muhlenberg,21177,30622,7050,17559,6013,23572
Kentucky,Nelson,21179,46233,11791,26977,7465,34442
Kentucky,Nicholas,21181,7269,1911,4120,1238,5358
Kentucky,Ohio,21183,23994,6347,13304,4343,17647
Kentucky,Oldham,21185,66799,18691,38979,9129,48108
Kentucky,Owen,21187,10901,2614,6204,2083,8287
Kentucky,Owsley,21189,4415,1082,2451,882,3333
Kentucky,Pendleton,21191,14590,3637,8550,2403,10953
Kentucky,Perry,21193,25758,6410,14855,4493,19348
Kentucky,Pike,21195,57876,13285,33345,11246,44591
Kentucky,Powell,21197,12359,3203,7145,2011,9156
Kentucky,Pulaski,21199,64979,15750,36899,12330,49229
Kentucky,Robertson,21201,2108,471,1174,463,1637
Kentucky,Rockcastle,21203,16695,3891,9671,3133,12804
Kentucky,Rowan,21205,24460,6576,14341,3543,17884
Kentucky,Russell,21207,17923,4408,9888,3627,13515
Kentucky,Scott,21209,57004,15799,34155,7050,41205
Kentucky,Shelby,21211,49024,12164,29106,7754,36860
Kentucky,Simpson,21213,18572,4847,10622,3103,13725
Kentucky,Spencer,21215,19351,4779,11754,2818,14572
Kentucky,Taylor,21217,25769,6778,14275,4716,18991
Kentucky,Todd,21219,12294,3555,6744,1995,8739
Kentucky,Trigg,21221,14651,3410,7847,3394,11241
Kentucky,Trimble,21223,8471,2011,4949,1511,6460
Kentucky,Union,21225,14381,3363,8543,2475,11018
Kentucky,Warren,21227,132896,36842,78591,17463,96054
Kentucky,Washington,21229,12095,3046,6814,2235,9049
Kentucky,Wayne,21231,20333,4526,11374,4433,15807
Kentucky,Webster,21233,12942,3253,7346,2343,9689
Kentucky,Whitley,21235,36264,10420,20029,5815,25844
Kentucky,Wolfe,21237,7157,1772,3963,1422,5385
Kentucky,Woodford,21239,26734,6530,15024,5180,20204
Louisiana,Acadia,22001,62045,17402,34847,9796,44643
Louisiana,Allen,22003,25627,6239,15482,3906,19388
Louisiana,Ascension,22005,126604,36626,74435,15543,89978
Louisiana,Assumption,22007,21891,5085,12702,4104,16806
Louisiana,Avoyelles,22009,40144,10317,22872,6955,29827
Louisiana,Beauregard,22011,37497,10210,21325,5962,27287
Louisiana,Bienville,22013,13241,3205,7163,2873,10036
Louisiana,Bossier,22015,127039,34315,73849,18875,92724
Louisiana,Caddo,22017,240204,62109,135503,42592,178095
Louisiana,Calcasieu,22019,203436,55579,116892,30965,147857
Louisiana,Caldwell,22021,9918,2499,5620,1799,7419
Louisiana,Cameron,22023,6973,1692,4098,1183,5281
Louisiana,Catahoula,22025,9494,2202,5592,1700,7292
Louisiana,Claiborne,22027,15670,3036,9578,3056,12634
Louisiana,Concordia,22029,19259,5006,10827,3426,14253
Louisiana,De Soto,22031,27463,7148,15299,5016,20315
Louisiana,East Baton Rouge,22033,440059,114786,260844,64429,325273
Louisiana,East Carroll,22035,6861,1786,4028,1047,5075
Louisiana,East Feliciana,22037,19135,3832,11790,3513,15303
Louisiana,Evangeline,22039,33395,9154,18955,5286,24241
Louisiana,Franklin,22041,20015,5514,10813,3688,14501
Louisiana,Grant,22043,22389,5133,13781,3475,17256
Louisiana,Iberia,22045,69830,19513,39376,10941,50317
Louisiana,Iberville,22047,32511,7396,19792,5323,25115
Louisiana,Jackson,22049,15744,3700,8805,3239,12044
Louisiana,Jefferson,22051,432493,103652,252338,76503,328841
Louisiana,Jefferson Davis,22053,31368,8705,17416,5247,22663
Louisiana,Lafayette,22055,244390,63708,147042,33640,180682
Louisiana,Lafourche,22057,97614,24915,57129,15570,72699
Louisiana,LaSalle,22059,14892,3721,8613,2558,11171
Louisiana,Lincoln,22061,46742,12633,27573,6536,34109
Louisiana,Livingston,22063,140789,39066,82960,18763,101723
Louisiana,Madison,22065,10951,2836,6480,1635,8115
Louisiana,Morehouse,22067,24874,6570,13490,4814,18304
Louisiana,Natchitoches,22069,38158,10751,20876,6531,27407
Louisiana,Orleans,22071,390144,86753,242690,60701,303391
Louisiana,Ouachita,22073,153279,41970,87799,23510,111309
Louisiana,Plaquemines,22075,23197,6494,13453,3250,16703
Louisiana,Pointe Coupee,22077,21730,5144,11938,4648,16586
Louisiana,Rapides,22079,129648,35116,72824,21708,94532
Louisiana,Red River,22081,8442,2148,4634,1660,6294
Louisiana,Richland,22083,20122,5128,11350,3644,14994
Louisiana,Sabine,22085,23884,6036,12787,5061,17848
Louisiana,St. Bernard,22087,47244,13437,28142,5665,33807
Louisiana,St. Charles,22089,53100,14101,31533,7466,38999
Louisiana,St. Helena,22091,10132,2295,5746,2091,7837
Louisiana,St. James,22093,21096,5296,12058,3742,15800
Louisiana,St. John the Baptist,22095,42837,11515,25012,6310,31322
Louisiana,St. Landry,22097,82124,23726,44759,13639,58398
Louisiana,St. Martin,22099,53431,13944,31087,8400,39487
Louisiana,St. Mary,22101,49348,12868,28069,8411,36480
Louisiana,St. Tammany,22103,260419,67472,147387,45560,192947
Louisiana,Tangipahoa,22105,134758,36912,77734,20112,97846
Louisiana,Tensas,22107,4334,1075,2144,1115,3259
Louisiana,Terrebonne,22109,110461,30225,63733,16503,80236
Louisiana,Union,22111,22108,5236,12211,4661,16872
Louisiana,Vermilion,22113,59511,16351,33754,9406,43160
Louisiana,Vernon,22115,47429,12933,28482,6014,34496
Louisiana,Washington,22117,46194,12047,25593,8554,34147
Louisiana,Webster,22119,38340,9441,21139,7760,28899
Louisiana,West Baton Rouge,22121,26465,6900,15790,3775,19565
Louisiana,West Carroll,22123,10830,2689,6037,2104,8141
Louisiana,West Feliciana,22125,15568,2816,10346,2406,12752
Louisiana,Winn,22127,13904,3156,8091,2657,10748
Maine,Androscoggin,23001,108277,26105,62506,19666,82172
Maine,Aroostook,23003,67055,13729,36609,16717,53326
Maine,Cumberland,23005,295003,61514,177329,56160,233489
Maine,Franklin,23007,30199,6346,16997,6856,23853
Maine,Hancock,23009,54987,10376,30719,13892,44611
Maine,Kennebec,23011,122302,26271,70881,25150,96031
Maine,Knox,23013,39772,7629,21787,10356,32143
Maine,Lincoln,23015,34634,6382,18489,9763,28252
Maine,Oxford,23017,57975,11614,33268,13093,46361
Maine,Penobscot,23019,152148,32758,90280,29110,119390
Maine,Piscataquis,23021,16785,3129,9062,4594,13656
Maine,Sagadahoc,23023,35856,7422,20274,8160,28434
Maine,Somerset,23025,50484,10478,29231,10775,40006
Maine,Waldo,23027,39715,8117,22337,9261,31598
Maine,Washington,23029,31379,6615,16971,7793,24764
Maine,York,23031,207641,42673,121049,43919,164968
Maryland,Allegany,24001,70416,14821,41124,14471,55595
Maryland,Anne Arundel,24003,579234,142214,350019,87001,437020
Maryland,Baltimore,24005,827370,201482,480584,145304,625888
Maryland,Calvert,24009,92525,23442,54762,14321,69083
Maryland,Caroline,24011,33406,8576,19256,5574,24830
Maryland,Carroll,24013,168447,40530,98805,29112,127917
Maryland,Cecil,24015,102855,25382,60797,16676,77473
Maryland,Charles,24017,163257,42859,99391,21007,120398
Maryland,Dorchester,24019,31929,7303,17563,7063,24626
Maryland,Frederick,24021,259547,66646,154447,38454,192901
Maryland,Garrett,24023,29014,5882,16419,6713,23132
Maryland,Harford,24025,255441,62387,150761,42293,193054
Maryland,Howard,24027,325690,86367,192827,46496,239323
Maryland,Kent,24029,19422,3842,10316,5264,15580
Maryland,Montgomery,24031,1050688,265334,616652,168702,785354
Maryland,Prince George's,24033,909327,227624,555406,126297,681703
Maryland,Queen Anne's,24035,50381,11823,28877,9681,38558
Maryland,St. Mary's,24037,113510,30186,68128,15196,83324
Maryland,Somerset,24039,25616,5639,15541,4436,19977
Maryland,Talbot,24041,37181,7417,18707,11057,29764
Maryland,Washington,24043,151049,36072,88548,26429,114977
Maryland,Wicomico,24045,103609,27989,58682,16938,75620
Maryland,Worcester,24047,52276,9828,27691,14757,42448
Maryland,Baltimore city,24510,593490,136076,371260,86154,457414
Massachusetts,Barnstable,25001,212990,35537,110536,66917,177453
Massachusetts,Berkshire,25003,124944,24232,70789,29923,100712
Massachusetts,Bristol,25005,565217,130480,336923,97814,434737
Massachusetts,Dukes,25007,17332,3346,9640,4346,13986
Massachusetts,Essex,25009,789034,187612,462893,138529,601422
Massachusetts,Franklin,25011,70180,13188,40774,16218,56992
Massachusetts,Hampden,25013,466372,113445,272120,80807,352927
Massachusetts,Hampshire,25015,160830,36195,95829,28806,124635
Massachusetts,Middlesex,25017,1611699,361903,997510,252286,1249796
Massachusetts,Nantucket,25019,11399,2566,7141,1692,8833
Massachusetts,Norfolk,25021,706775,164602,420350,121823,542173
Massachusetts,Plymouth,25023,521202,123248,301021,96933,397954
Massachusetts,Suffolk,25025,803907,164393,540285,99229,639514
Massachusetts,Worcester,25027,830622,197484,499129,134009,633138
Michigan,Alcona,26001,10405,1435,5209,3761,8970
Michigan,Alger,26003,9108,1520,5195,2393,7588
Michigan,Allegan,26005,118081,30708,67274,20099,87373
Michigan,Alpena,26007,28405,5881,15743,6781,22524
Michigan,Antrim,26009,23324,4530,12258,6536,18794
Michigan,Arenac,26011,14883,2942,8101,3840,11941
Michigan,Baraga,26013,8209,1576,4766,1867,6633
Michigan,Barry,26015,61550,14898,35016,11636,46652
Michigan,Bay,26017,103126,22622,58862,21642,80504
Michigan,Benzie,26019,17766,3467,9511,4788,14299
Michigan,Berrien,26021,153401,36768,85511,31122,116633
Michigan,Branch,26023,43517,10950,24438,8129,32567
Michigan,Calhoun,26025,134159,33949,75776,24434,100210
Michigan,Cass,26027,51787,11859,28779,11149,39928
Michigan,Charlevoix,26029,26143,5329,14245,6569,20814
Michigan,Cheboygan,26031,25276,4553,13629,7094,20723
Michigan,Chippewa,26033,37349,7661,22685,7003,29688
Michigan,Clare,26035,30950,6706,16776,7468,24244
Michigan,Clinton,26037,79595,19308,46393,13894,60287
Michigan,Crawford,26039,14029,2787,7622,3620,11242
Michigan,Delta,26041,35784,7723,19168,8893,28061
Michigan,Dickinson,26043,25239,5552,13933,5754,19687
Michigan,Eaton,26045,110268,25395,63839,21034,84873
Michigan,Emmet,26047,33415,6981,18640,7794,26434
Michigan,Genesee,26049,405813,99935,232957,72921,305878
Michigan,Gladwin,26051,25449,5200,13342,6907,20249
Michigan,Gogebic,26053,13975,2605,7372,3998,11370
Michigan,Grand Traverse,26055,93088,20583,53179,19326,72505
Michigan,Gratiot,26057,40711,9258,24215,7238,31453
Michigan,Hillsdale,26059,45605,11184,25219,9202,34421
Michigan,Houghton,26061,35684,9490,19803,6391,26194
Michigan,Huron,26063,30981,6544,16403,8034,24437
Michigan,Ingham,26065,292406,73320,178439,40647,219086
Michigan,Ionia,26067,64697,15737,39116,9844,48960
Michigan,Iosco,26069,25127,4584,12980,7563,20543
Michigan,Iron,26071,11066,2035,5576,3455,9031
Michigan,Isabella,26073,69872,17458,43173,9241,52414
Michigan,Jackson,26075,158510,37551,92007,28952,120959
Michigan,Kalamazoo,26077,265066,65843,158314,40909,199223
Michigan,Kalkaska,26079,18038,4034,10276,3728,14004
Michigan,Kent,26081,656955,173876,390259,92820,483079
Michigan,Keweenaw,26083,2116,338,971,807,1778
Michigan,Lake,26085,11853,2119,6196,3538,9734
Michigan,Lapeer,26087,87607,19683,51391,16533,67924
Michigan,Leelanau,26089,21761,3848,10957,6956,17913
Michigan,Lenawee,26091,98451,23231,56072,19148,75220
Michigan,Livingston,26093,191995,44462,113163,34370,147533
Michigan,Luce,26095,6229,1122,3794,1313,5107
Michigan,Mackinac,26097,10799,1892,5823,3084,8907
Michigan,Macomb,26099,873972,199960,521744,152268,674012
Michigan,Manistee,26101,24558,4682,13418,6458,19876
Michigan,Marquette,26103,66699,14627,38984,13088,52072
Michigan,Mason,26105,29144,6455,15620,7069,22689
Michigan,Mecosta,26107,43453,10730,24625,8098,32723
Michigan,Menominee,26109,22780,4451,12503,5826,18329
Michigan,Midland,26111,83156,19765,47686,15705,63391
Michigan,Missaukee,26113,15118,3759,8224,3135,11359
Michigan,Monroe,26115,150500,34991,87281,28228,115509
Michigan,Montcalm,26117,63888,15381,36914,11593,48507
Michigan,Montmorency,26119,9328,1525,4739,3064,7803
Michigan,Muskegon,26121,173566,43573,99432,30561,129993
Michigan,Newaygo,26123,48980,11964,27329,9687,37016
Michigan,Oakland,26125,1257584,287732,752176,217676,969852
Michigan,Oceana,26127,26467,6496,14324,5647,19971
Michigan,Ogemaw,26129,20997,4256,11227,5514,16741
Michigan,Ontonagon,26131,5720,803,2763,2154,4917
Michigan,Osceola,26133,23460,5722,12675,5063,17738
Michigan,Oscoda,26135,8241,1742,4224,2275,6499
Michigan,Otsego,26137,24668,5661,13644,5363,19007
Michigan,Ottawa,26139,291830,81207,165335,45288,210623
Michigan,Presque Isle,26141,12592,2165,6332,4095,10427
Michigan,Roscommon,26143,24019,3877,12152,7990,20142
Michigan,Saginaw,26145,190539,46261,106864,37414,144278
Michigan,St. Clair,26147,159128,36021,92228,30879,123107
Michigan,St. Joseph,26149,60964,16108,33599,11257,44856
Michigan,Sanilac,26151,41170,9662,22412,9096,31508
Michigan,Schoolcraft,26153,8094,1528,4337,2229,6566
Michigan,Shiawassee,26155,68122,15872,39279,12971,52250
Michigan,Tuscola,26157,52245,11607,29758,10880,40638
Michigan,Van Buren,26159,75677,19189,42363,14125,56488
Michigan,Washtenaw,26161,367601,87609,226623,53369,279992
Michigan,Wayne,26163,1749343,452883,1019930,276530,1296460
Michigan,Wexford,26165,33631,8394,18656,6581,25237
Minnesota,Aitkin,27001,15886,2835,7678,5373,13051
Minnesota,Anoka,27003,356921,92371,212769,51781,264550
Minnesota,Becker,27005,34423,9022,18127,7274,25401
Minnesota,Beltrami,27007,47188,13582,25833,7773,33606
Minnesota,Benton,27009,40889,11260,23771,5858,29629
Minnesota,Big Stone,27011,4991,1159,2493,1339,3832
Minnesota,Blue Earth,27013,67653,17129,40897,9627,50524
Minnesota,Brown,27015,25008,6202,13471,5335,18806
Minnesota,Carlton,27017,35871,8757,20851,6263,27114
Minnesota,Carver,27019,105089,30368,61471,13250,74721
Minnesota,Cass,27021,29779,6727,15165,7887,23052
Minnesota,Chippewa,27023,11800,3073,6160,2567,8727
Minnesota,Chisago,27025,56579,14036,33602,8941,42543
Minnesota,Clay,27027,64222,18716,36918,8588,45506
Minnesota,Clearwater,27029,8818,2370,4644,1804,6448
Minnesota,Cook,27031,5463,894,2968,1601,4569
Minnesota,Cottonwood,27033,11196,2985,5621,2590,8211
Minnesota,Crow Wing,27035,65055,15114,34995,14946,49941
Minnesota,Dakota,27037,429021,113392,252618,63011,315629
Minnesota,Dodge,27039,20934,5845,11915,3174,15089
Minnesota,Douglas,27041,38141,8903,20312,8926,29238
Minnesota,Faribault,27043,13653,3266,7213,3174,10387
Minnesota,Fillmore,27045,21067,5607,10991,4469,15460
Minnesota,Freeborn,27047,30281,7234,16220,6827,23047
Minnesota,Goodhue,27049,46340,11151,25852,9337,35189
Minnesota,Grant,27051,5972,1441,3098,1433,4531
Minnesota,Hennepin,27053,1265843,305440,776750,183653,960403
Minnesota,Houston,27055,18600,4435,10065,4100,14165
Minnesota,Hubbard,27057,21491,4955,11113,5423,16536
Minnesota,Isanti,27059,40596,10341,23525,6730,30255
Minnesota,Itasca,27061,45130,10269,23983,10878,34861
Minnesota,Jackson,27063,9846,2305,5266,2275,7541
Minnesota,Kanabec,27065,16337,3844,9073,3420,12493
Minnesota,Kandiyohi,27067,43199,11597,23358,8244,31602
Minnesota,Kittson,27069,4298,1040,2189,1069,3258
Minnesota,Koochiching,27071,12229,2451,6514,3264,9778
Minnesota,Lac qui Parle,27073,6623,1495,3281,1847,5128
Minnesota,Lake,27075,10641,2199,5587,2855,8442
Minnesota,Lake of the Woods,27077,3740,751,2040,949,2989
Minnesota,Le Sueur,27079,28887,7530,16244,5113,21357
Minnesota,Lincoln,27081,5639,1423,2801,1415,4216
Minnesota,Lyon,27083,25474,7396,13886,4192,18078
Minnesota,McLeod,27085,35893,8911,20110,6872,26982
Minnesota,Mahnomen,27087,5527,1909,2664,954,3618
Minnesota,Marshall,27089,9336,2313,4941,2082,7023
Minnesota,Martin,27091,19683,4708,10228,4747,14975
Minnesota,Meeker,27093,23222,6081,12376,4765,17141
Minnesota,Mille Lacs,27095,26277,6768,14620,4889,19509
Minnesota,Morrison,27097,33386,8425,18277,6684,24961
Minnesota,Mower,27099,40062,10961,21682,7419,29101
Minnesota,Murray,27101,8194,1938,4123,2133,6256
Minnesota,Nicollet,27103,34274,8974,19577,5723,25300
Minnesota,Nobles,27105,21629,6472,11531,3626,15157
Minnesota,Norman,27107,6375,1690,3315,1370,4685
Minnesota,Olmsted,27109,158293,41924,91133,25236,116369
Minnesota,Otter Tail,27111,58746,13925,30453,14368,44821
Minnesota,Pennington,27113,14119,3485,7974,2660,10634
Minnesota,Pine,27115,29579,6256,16965,6358,23323
Minnesota,Pipestone,27117,9126,2579,4653,1894,6547
Minnesota,Polk,27119,31364,8524,17066,5774,22840
Minnesota,Pope,27121,11249,2548,5918,2783,8701
Minnesota,Ramsey,27123,550321,143160,325334,81827,407161
Minnesota,Red Lake,27125,4055,1064,2117,874,2991
Minnesota,Redwood,27127,15170,4081,7816,3273,11089
Minnesota,Renville,27129,14548,3692,7791,3065,10856
Minnesota,Rice,27131,66972,17755,38634,10583,49217
Minnesota,Rock,27133,9315,2558,4846,1911,6757
Minnesota,Roseau,27135,15165,4021,8394,2750,11144
Minnesota,St. Louis,27137,199070,44637,114517,39916,154433
Minnesota,Scott,27139,149013,43955,88154,16904,105058
Minnesota,Sherburne,27141,97238,27845,57994,11399,69393
Minnesota,Sibley,27143,14865,3748,8307,2810,11117
Minnesota,Stearns,27145,161075,43947,92206,24922,117128
Minnesota,Steele,27147,36649,9793,20150,6706,26856
Minnesota,Stevens,27149,9805,2789,5314,1702,7016
Minnesota,Swift,27151,9266,2319,4868,2079,6947
Minnesota,Todd,27153,24664,6391,12822,5451,18273
Minnesota,Traverse,27155,3259,743,1688,828,2516
Minnesota,Wabasha,27157,21627,5071,11677,4879,16556
Minnesota,Wadena,27159,13682,3802,6959,2921,9880
Minnesota,Waseca,27161,18612,4750,10402,3460,13862
Minnesota,Washington,27163,262440,69580,151993,40867,192860
Minnesota,Watonwan,27165,10897,2923,5740,2234,7974
Minnesota,Wilkin,27167,6207,1546,3441,1220,4661
Minnesota,Winona,27169,50484,11859,29729,8896,38625
Minnesota,Wright,27171,138377,41541,78863,17973,96836
Minnesota,Yellow Medicine,27173,9709,2475,5214,2020,7234
Mississippi,Adams,28001,30693,6691,17997,6005,24002
Mississippi,Alcorn,28003,36953,9130,20858,6965,27823
Mississippi,Amite,28005,12297,2731,6599,2967,9566
Mississippi,Attala,28007,18174,4964,9673,3537,13210
Mississippi,Benton,28009,8259,1941,4752,1566,6318
Mississippi,Bolivar,28011,30628,8406,17225,4997,22222
Mississippi,Calhoun,28013,14361,3628,7936,2797,10733
Mississippi,Carroll,28015,9947,2023,5512,2412,7924
Mississippi,Chickasaw,28017,17103,4683,9419,3001,12420
Mississippi,Choctaw,28019,8210,1925,4456,1829,6285
Mississippi,Claiborne,28021,8988,2511,4978,1499,6477
Mississippi,Clarke,28023,15541,3771,8531,3239,11770
Mississippi,Clay,28025,19316,4771,10896,3649,14545
Mississippi,Coahoma,28027,22124,6681,11902,3541,15443
Mississippi,Copiah,28029,28065,7337,15595,5133,20728
Mississippi,Covington,28031,18636,4978,10458,3200,13658
Mississippi,DeSoto,28033,184945,51710,108730,24505,133235
Mississippi,Forrest,28035,74897,20022,44463,10412,54875
Mississippi,Franklin,28037,7713,1928,4182,1603,5785
Mississippi,George,28039,24500,7042,13879,3579,17458
Mississippi,Greene,28041,13586,2893,8619,2074,10693
Mississippi,Grenada,28043,20758,5373,11624,3761,15385
Mississippi,Hancock,28045,47632,10437,27353,9842,37195
Mississippi,Harrison,28047,208080,55128,120871,32081,152952
Mississippi,Hinds,28049,231840,62721,134853,34266,169119
Mississippi,Holmes,28051,17010,4892,9448,2670,12118
Mississippi,Humphreys,28053,8064,2302,4334,1428,5762
Mississippi,Issaquena,28055,1327,198,908,221,1129
Mississippi,Itawamba,28057,23390,5949,13228,4213,17441
Mississippi,Jackson,28059,143617,36420,83740,23457,107197
Mississippi,Jasper,28061,16383,4000,8984,3399,12383
Mississippi,Jefferson,28063,6990,1710,4065,1215,5280
Mississippi,Jefferson Davis,28065,11128,2422,6136,2570,8706
Mississippi,Jones,28067,68098,19055,37216,11827,49043
Mississippi,Kemper,28069,9742,2292,5413,2037,7450
Mississippi,Lafayette,28071,54019,13564,33244,7211,40455
Mississippi,Lamar,28073,63343,16946,37301,9096,46397
Mississippi,Lauderdale,28075,74125,19219,41736,13170,54906
Mississippi,Lawrence,28077,12586,3386,6909,2291,9200
Mississippi,Leake,28079,22786,6292,12684,3810,16494
Mississippi,Lee,28081,85436,23267,49213,12956,62169
Mississippi,Leflore,28083,28183,8704,15329,4150,19479
Mississippi,Lincoln,28085,34153,8721,19469,5963,25432
Mississippi,Lowndes,28087,58595,15297,33763,9535,43298
Mississippi,Madison,28089,106272,29056,62492,14724,77216
Mississippi,Marion,28091,24573,6105,13715,4753,18468
Mississippi,Marshall,28093,35294,8285,20603,6406,27009
Mississippi,Monroe,28095,35252,8677,19621,6954,26575
Mississippi,Montgomery,28097,9775,2376,5231,2168,7399
Mississippi,Neshoba,28099,29118,8834,15602,4682,20284
Mississippi,Newton,28101,21018,5982,11451,3585,15036
Mississippi,Noxubee,28103,10417,2795,5889,1733,7622
Mississippi,Oktibbeha,28105,49587,12287,31347,5953,37300
Mississippi,Panola,28107,34192,9229,19379,5584,24963
Mississippi,Pearl River,28109,55535,14179,30755,10601,41356
Mississippi,Perry,28111,11973,2906,6832,2235,9067
Mississippi,Pike,28113,39288,11317,21058,6913,27971
Mississippi,Pontotoc,28115,32174,9234,18060,4880,22940
Mississippi,Prentiss,28117,25126,6330,14165,4631,18796
Mississippi,Quitman,28119,6792,1713,3848,1231,5079
Mississippi,Rankin,28121,155271,38683,92262,24326,116588
Mississippi,Scott,28123,28124,8125,15662,4337,19999
Mississippi,Sharkey,28125,4321,1170,2285,866,3151
Mississippi,Simpson,28127,26658,6837,14997,4824,19821
Mississippi,Smith,28129,15916,3984,8667,3265,11932
Mississippi,Stone,28131,18336,4738,10516,3082,13598
Mississippi,Sunflower,28133,25110,6200,15301,3609,18910
Mississippi,Tallahatchie,28135,13809,2995,8707,2107,10814
Mississippi,Tate,28137,28321,7574,15884,4863,20747
Mississippi,Tippah,28139,22015,5907,12387,3721,16108
Mississippi,Tishomingo,28141,19383,4564,10795,4024,14819
Mississippi,Tunica,28143,9632,3036,5357,1239,6596
Mississippi,Union,28145,28815,7859,16098,4858,20956
Mississippi,Walthall,28147,14286,3528,7912,2846,10758
Mississippi,Warren,28149,45381,11748,25807,7826,33633
Mississippi,Washington,28151,43909,12294,24291,7324,31615
Mississippi,Wayne,28153,20183,5365,11262,3556,14818
Mississippi,Webster,28155,9689,2496,5454,1739,7193
Mississippi,Wilkinson,28157,8630,1967,5127,1536,6663
Mississippi,Winston,28159,17955,4438,9837,3680,13517
Mississippi,Yalobusha,28161,12108,2917,6646,2545,9191
Mississippi,Yazoo,28163,29690,6696,19186,3808,22994
Missouri,Adair,29001,25343,6631,14883,3829,18712
Missouri,Andrew,29003,17712,4447,9831,3434,13265
Missouri,Atchison,29005,5143,1128,2670,1345,4015
Missouri,Audrain,29007,25388,6280,14489,4619,19108
Missouri,Barry,29009,35789,8868,19398,7523,26921
Missouri,Barton,29011,11754,3002,6259,2493,8752
Missouri,Bates,29013,16172,4074,8933,3165,12098
Missouri,Benton,29015,19443,3681,9689,6073,15762
Missouri,Bollinger,29017,12133,2829,6748,2556,9304
Missouri,Boone,29019,180463,45355,112024,23084,135108
Missouri,Buchanan,29021,87364,21788,50976,14600,65576
Missouri,Butler,29023,42478,10799,23534,8145,31679
Missouri,Caldwell,29025,9020,2325,4884,1811,6695
Missouri,Callaway,29027,44743,10772,26493,7478,33971
Missouri,Camden,29029,46305,8852,24069,13384,37453
Missouri,Cape Girardeau,29031,78871,19890,45478,13503,58981
Missouri,Carroll,29033,8679,2138,4624,1917,6541
Missouri,Carter,29035,5982,1506,3226,1250,4476
Missouri,Cass,29037,105780,27540,59906,18334,78240
Missouri,Cedar,29039,14349,3771,7175,3403,10578
Missouri,Chariton,29041,7426,1855,3766,1805,5571
Missouri,Christian,29043,88595,24096,50274,14225,64499
Missouri,Clark,29045,6797,1668,3670,1459,5129
Missouri,Clay,29047,249948,65268,148588,36092,184680
Missouri,Clinton,29049,20387,5186,11498,3703,15201
Missouri,Cole,29051,76745,18919,44535,13291,57826
Missouri,Cooper,29053,17709,4266,10197,3246,13443
Missouri,Crawford,29055,23920,5876,13236,4808,18044
Missouri,Dade,29057,7561,1734,4022,1805,5827
Missouri,Dallas,29059,16878,4327,9044,3507,12551
Missouri,Daviess,29061,8278,2290,4237,1751,5988
Missouri,DeKalb,29063,12547,2367,8102,2078,10180
Missouri,Dent,29065,15573,3771,8324,3478,11802
Missouri,Douglas,29067,13185,3134,6768,3283,10051
Missouri,Dunklin,29069,29131,8094,15557,5480,21037
Missouri,Franklin,29071,103967,25656,59579,18732,78311
Missouri,Gasconade,29073,14706,3327,7983,3396,11379
Missouri,Gentry,29075,6571,1787,3477,1307,4784
Missouri,Greene,29077,293086,70020,173961,49105,223066
Missouri,Grundy,29079,9850,2627,5020,2203,7223
Missouri,Harrison,29081,8352,2204,4243,1905,6148
Missouri,Henry,29083,21824,5216,11781,4827,16608
Missouri,Hickory,29085,9544,1758,4611,3175,7786
Missouri,Holt,29087,4403,963,2286,1154,3440
Missouri,Howard,29089,10001,2620,5413,1968,7381
Missouri,Howell,29091,40117,10450,21605,8062,29667
Missouri,Iron,29093,10125,2310,5600,2215,7815
Missouri,Jackson,29095,703011,179524,415356,108131,523487
Missouri,Jasper,29097,121328,33113,68843,19372,88215
Missouri,Jefferson,29099,225081,56269,133817,34995,168812
Missouri,Johnson,29101,54062,14222,32871,6969,39840
Missouri,Knox,29103,3959,1025,2057,877,2934
Missouri,Laclede,29105,35723,9606,19766,6351,26117
Missouri,Lafayette,29107,32708,8249,18265,6194,24459
Missouri,Lawrence,29109,38355,10633,20647,7075,27722
Missouri,Lewis,29111,9776,2512,5429,1835,7264
Missouri,Lincoln,29113,59013,16265,34674,8074,42748
Missouri,Linn,29115,11920,3031,6341,2548,8889
Missouri,Livingston,29117,15227,3453,8803,2971,11774
Missouri,McDonald,29119,22837,6381,12895,3561,16456
Missouri,Macon,29121,15117,3779,7894,3444,11338
Missouri,Madison,29123,12088,3027,6690,2371,9061
Missouri,Maries,29125,8697,1919,4862,1916,6778
Missouri,Marion,29127,28530,7369,15933,5228,21161
Missouri,Mercer,29129,3617,947,1856,814,2670
Missouri,Miller,29131,25619,6525,14084,5010,19094
Missouri,Mississippi,29133,13180,3030,7757,2393,10150
Missouri,Moniteau,29135,16132,4285,9237,2610,11847
Missouri,Monroe,29137,8644,2045,4526,2073,6599
Missouri,Montgomery,29139,11551,2774,6311,2466,8777
Missouri,Morgan,29141,20627,5155,10635,4837,15472
Missouri,New Madrid,29143,17076,4311,9430,3335,12765
Missouri,Newton,29145,58236,15135,32366,10735,43101
Missouri,Nodaway,29147,22092,5322,13315,3455,16770
Missouri,Oregon,29149,10529,2557,5476,2496,7972
Missouri,Osage,29151,13615,3492,7708,2415,10123
Missouri,Ozark,29153,9174,1899,4591,2684,7275
Missouri,Pemiscot,29155,15805,4402,8620,2783,11403
Missouri,Perry,29157,19136,4807,10649,3680,14329
Missouri,Pettis,29159,42339,11481,23614,7244,30858
Missouri,Phelps,29161,44573,11390,25626,7557,33183
Missouri,Pike,29163,18302,4306,10733,3263,13996
Missouri,Platte,29165,104418,26793,61984,15641,77625
Missouri,Polk,29167,32149,8516,17763,5870,23633
Missouri,Pulaski,29169,52607,15596,32214,4797,37011
Missouri,Putnam,29171,4696,1156,2370,1170,3540
Missouri,Ralls,29173,10309,2365,5651,2293,7944
Missouri,Randolph,29175,24748,5929,14570,4249,18819
Missouri,Ray,29177,23018,5648,13027,4343,17370
Missouri,Reynolds,29179,6270,1379,3407,1484,4891
Missouri,Ripley,29181,13288,3292,7226,2770,9996
Missouri,St. Charles,29183,402022,101906,236646,63470,300116
Missouri,St. Clair,29185,9397,2030,4777,2590,7367
Missouri,Ste. Genevieve,29186,17894,4244,10052,3598,13650
Missouri,St. Francois,29187,67215,15498,40544,11173,51717
Missouri,St. Louis,29189,994205,241625,568300,184280,752580
Missouri,Saline,29195,22761,5918,12588,4255,16843
Missouri,Schuyler,29197,4660,1315,2435,910,3345
Missouri,Scotland,29199,4902,1530,2464,908,3372
Missouri,Scott,29201,38280,9950,21229,7101,28330
Missouri,Shannon,29203,8166,1907,4411,1848,6259
Missouri,Shelby,29205,5930,1547,3093,1290,4383
Missouri,Stoddard,29207,29025,6978,16150,5897,22047
Missouri,Stone,29209,31952,5786,16068,10098,26166
Missouri,Sullivan,29211,6089,1508,3316,1265,4581
Missouri,Taney,29213,55928,13236,30313,12379,42692
Missouri,Texas,29215,25398,5916,14026,5456,19482
Missouri,Vernon,29217,20563,5489,11015,4059,15074
Missouri,Warren,29219,35649,9172,20143,6334,26477
Missouri,Washington,29221,24730,6085,14381,4264,18645
Missouri,Wayne,29223,12873,2842,6900,3131,10031
Missouri,Webster,29225,39592,11570,21793,6229,28022
Missouri,Worth,29227,2013,436,1055,522,1577
Missouri,Wright,29229,18289,5112,9590,3587,13177
Missouri,St. Louis city,29510,300576,63312,194256,43008,237264
Montana,Beaverhead,30001,9453,2032,5313,2108,7421
Montana,Big Horn,30003,13319,4830,6714,1775,8489
Montana,Blaine,30005,6681,2145,3478,1058,4536
Montana,Broadwater,30007,6237,1339,3399,1499,4898
Montana,Carbon,30009,10725,2015,5839,2871,8710
Montana,Carter,30011,1252,292,633,327,960
Montana,Cascade,30013,81366,19890,45921,15555,61476
Montana,Chouteau,30015,5635,1404,3038,1193,4231
Montana,Custer,30017,11402,2644,6398,2360,8758
Montana,Daniels,30019,1690,378,834,478,1312
Montana,Dawson,30021,8613,2110,4744,1759,6503
Montana,Deer Lodge,30023,9140,1481,5417,2242,7659
Montana,Fallon,30025,2846,832,1530,484,2014
Montana,Fergus,30027,11050,2474,5791,2785,8576
Montana,Flathead,30029,103806,24446,58366,20994,79360
Montana,Gallatin,30031,114434,26677,72727,15030,87757
Montana,Garfield,30033,1258,312,643,303,946
Montana,Glacier,30035,13753,4697,7323,1733,9056
Montana,Golden Valley,30037,821,194,399,228,627
Montana,Granite,30039,3379,550,1761,1068,2829
Montana,Hill,30041,16484,5081,8883,2520,11403
Montana,Jefferson,30043,12221,2706,6797,2718,9515
Montana,Judith Basin,30045,2007,426,1030,551,1581
Montana,Lake,30047,30458,7786,15773,6899,22672
Montana,Lewis and Clark,30049,69432,16461,39500,13471,52971
Montana,Liberty,30051,2337,525,1296,516,1812
Montana,Lincoln,30053,19980,3893,10185,5902,16087
Montana,McCone,30055,1664,377,836,451,1287
Montana,Madison,30057,8600,1444,4616,2540,7156
Montana,Meagher,30059,1862,374,899,589,1488
Montana,Mineral,30061,4397,871,2226,1300,3526
Montana,Missoula,30063,119600,26089,74174,19337,93511
Montana,Musselshell,30065,4633,938,2414,1281,3695
Montana,Park,30067,16606,3128,9538,3940,13478
Montana,Petroleum,30069,487,93,269,125,394
Montana,Phillips,30071,3954,1011,2027,916,2943
Montana,Pondera,30073,5911,1579,3116,1216,4332
Montana,Powder River,30075,1682,316,900,466,1366
Montana,Powell,30077,6890,1115,4311,1464,5775
Montana,Prairie,30079,1077,212,504,361,865
Montana,Ravalli,30081,43806,9100,23078,11628,34706
Montana,Richland,30083,10803,2926,6217,1660,7877
Montana,Roosevelt,30085,11004,3982,5729,1293,7022
Montana,Rosebud,30087,8937,2803,4662,1472,6134
Montana,Sanders,30089,12113,2309,5885,3919,9804
Montana,Sheridan,30091,3309,746,1793,770,2563
Montana,Silver Bow,30093,34915,7931,20176,6808,26984
Montana,Stillwater,30095,9642,2251,5123,2268,7391
Montana,Sweet Grass,30097,3737,839,1873,1025,2898
Montana,Teton,30099,6147,1627,3093,1427,4520
Montana,Toole,30101,4736,1055,2760,921,3681
Montana,Treasure,30103,696,157,338,201,539
Montana,Valley,30105,7396,1830,3810,1756,5566
Montana,Wheatland,30107,2126,509,1076,541,1617
Montana,Wibaux,30109,969,219,500,250,750
Montana,Yellowstone,30111,161300,40965,92250,28085,120335
Nebraska,Adams,31001,31363,8433,17014,5916,22930
Nebraska,Antelope,31003,6298,1611,3172,1515,4687
Nebraska,Arthur,31005,463,129,235,99,334
Nebraska,Banner,31007,745,189,377,179,556
Nebraska,Blaine,31009,465,96,244,125,369
Nebraska,Boone,31011,5192,1297,2679,1216,3895
Nebraska,Box Butte,31013,10783,2949,5750,2084,7834
Nebraska,Boyd,31015,1919,394,930,595,1525
Nebraska,Brown,31017,2955,698,1459,798,2257
Nebraska,Buffalo,31019,49659,13492,28694,7473,36167
Nebraska,Burt,31021,6459,1586,3300,1573,4873
Nebraska,Butler,31023,8016,2044,4264,1708,5972
Nebraska,Cass,31025,26248,6724,14768,4756,19524
Nebraska,Cedar,31027,8402,2301,4251,1850,6101
Nebraska,Chase,31029,3924,1062,2028,834,2862
Nebraska,Cherry,31031,5689,1443,2986,1260,4246
Nebraska,Cheyenne,31033,8910,2241,4835,1834,6669
Nebraska,Clay,31035,6203,1670,3265,1268,4533
Nebraska,Colfax,31037,10709,3431,5796,1482,7278
Nebraska,Cuming,31039,8846,2353,4515,1978,6493
Nebraska,Custer,31041,10777,2787,5539,2451,7990
Nebraska,Dakota,31043,20026,6350,10890,2786,13676
Nebraska,Dawes,31045,8589,2098,4855,1636,6491
Nebraska,Dawson,31047,23595,6994,12551,4050,16601
Nebraska,Deuel,31049,1794,411,963,420,1383
Nebraska,Dixon,31051,5636,1567,2902,1167,4069
Nebraska,Dodge,31053,36565,9845,19623,7097,26720
Nebraska,Douglas,31055,571327,160606,333951,76770,410721
Nebraska,Dundy,31057,1693,340,910,443,1353
Nebraska,Fillmore,31059,5462,1193,3005,1264,4269
Nebraska,Franklin,31061,2979,654,1482,843,2325
Nebraska,Frontier,31063,2627,634,1358,635,1993
Nebraska,Furnas,31065,4676,1146,2345,1185,3530
Nebraska,Gage,31067,21513,5316,11649,4548,16197
Nebraska,Garden,31069,1837,386,919,532,1451
Nebraska,Garfield,31071,1969,398,996,575,1571
Nebraska,Gosper,31073,1990,469,1034,487,1521
Nebraska,Grant,31075,623,167,314,142,456
Nebraska,Greeley,31077,2356,583,1176,597,1773
Nebraska,Hall,31079,61353,18315,33775,9263,43038
Nebraska,Hamilton,31081,9324,2452,4968,1904,6872
Nebraska,Harlan,31083,3380,775,1682,923,2605
Nebraska,Hayes,31085,922,224,440,258,698
Nebraska,Hitchcock,31087,2762,679,1352,731,2083
Nebraska,Holt,31089,10067,2735,5118,2214,7332
Nebraska,Hooker,31091,682,156,315,211,526
Nebraska,Howard,31093,6445,1664,3386,1395,4781
Nebraska,Jefferson,31095,7046,1667,3655,1724,5379
Nebraska,Johnson,31097,5071,1044,3062,965,4027
Nebraska,Kearney,31099,6495,1726,3482,1287,4769
Nebraska,Keith,31101,8034,1775,4082,2177,6259
Nebraska,Keya Paha,31103,806,159,384,263,647
Nebraska,Kimball,31105,3632,841,1886,905,2791
Nebraska,Knox,31107,8332,2205,4012,2115,6127
Nebraska,Lancaster,31109,319090,84204,188984,45902,234886
Nebraska,Lincoln,31111,34914,8986,18916,7012,25928
Nebraska,Logan,31113,748,193,386,169,555
Nebraska,Loup,31115,664,155,335,174,509
Nebraska,McPherson,31117,494,103,272,119,391
Nebraska,Madison,31119,35099,9980,19426,5693,25119
Nebraska,Merrick,31121,7755,1905,4242,1608,5850
Nebraska,Morrill,31123,4642,1150,2487,1005,3492
Nebraska,Nance,31125,3519,850,1902,767,2669
Nebraska,Nemaha,31127,6972,1885,3668,1419,5087
Nebraska,Nuckolls,31129,4148,890,2129,1129,3258
Nebraska,Otoe,31131,16012,4178,8668,3166,11834
Nebraska,Pawnee,31133,2613,612,1251,750,2001
Nebraska,Perkins,31135,2891,774,1431,686,2117
Nebraska,Phelps,31137,9034,2343,4778,1913,6691
Nebraska,Pierce,31139,7148,1949,3796,1403,5199
Nebraska,Platte,31141,33470,9575,17990,5905,23895
Nebraska,Polk,31143,5213,1295,2686,1232,3918
Nebraska,Red Willow,31145,10724,2712,5753,2259,8012
Nebraska,Richardson,31147,7865,1831,4077,1957,6034
Nebraska,Rock,31149,1357,303,692,362,1054
Nebraska,Saline,31151,14224,4308,7728,2188,9916
Nebraska,Sarpy,31153,187196,55214,109320,22662,131982
Nebraska,Saunders,31155,21578,5708,11787,4083,15870
Nebraska,Scotts Bluff,31157,35618,9708,18922,6988,25910
Nebraska,Seward,31159,17284,4915,9400,2969,12369
Nebraska,Sheridan,31161,5246,1269,2576,1401,3977
Nebraska,Sherman,31163,3001,688,1471,842,2313
Nebraska,Sioux,31165,1166,228,582,356,938
Nebraska,Stanton,31167,5920,1569,3242,1109,4351
Nebraska,Thayer,31169,5003,1266,2459,1278,3737
Nebraska,Thomas,31171,722,178,353,191,544
Nebraska,Thurston,31173,7224,2831,3539,854,4393
Nebraska,Valley,31175,4158,1028,2057,1073,3130
Nebraska,Washington,31177,20729,5469,11397,3863,15260
Nebraska,Wayne,31179,9385,2535,5284,1566,6850
Nebraska,Webster,31181,3487,818,1853,816,2669
Nebraska,Wheeler,31183,783,158,402,223,625
Nebraska,York,31185,13679,3554,7265,2860,10125
Nevada,Churchill,32001,24909,6225,13925,4759,18684
Nevada,Clark,32003,2266715,570915,1353141,342659,1695800
Nevada,Douglas,32005,48905,8657,25747,14501,40248
Nevada,Elko,32007,52778,15622,30936,6220,37156
Nevada,Esmeralda,32009,873,133,428,312,740
Nevada,Eureka,32011,2029,528,1169,332,1501
Nevada,Humboldt,32013,16831,4906,9498,2427,11925
Nevada,Lander,32015,5532,1569,3078,885,3963
Nevada,Lincoln,32017,5183,1157,2715,1311,4026
Nevada,Lyon,32019,57510,13384,31935,12191,44126
Nevada,Mineral,32021,4505,958,2402,1145,3547
Nevada,Nye,32023,46523,8488,23939,14096,38035
Nevada,Pershing,32027,6725,1223,4399,1103,5502
Nevada,Storey,32029,4123,559,2237,1327,3564
Nevada,Washoe,32031,471519,111375,280767,79377,360144
Nevada,White Pine,32033,9580,2126,5700,1754,7454
Nevada,Carson City,32510,55916,12447,31896,11573,43469
New Hampshire,Belknap,33001,61303,12346,34981,13976,48957
New Hampshire,Carroll,33003,48910,8274,26469,14167,40636
New Hampshire,Cheshire,33005,76085,16395,43956,15734,59690
New Hampshire,Coos,33007,31563,5610,18307,7646,25953
New Hampshire,Grafton,33009,89886,18402,52303,19181,71484
New Hampshire,Hillsborough,33011,417025,93399,255976,67650,323626
New Hampshire,Merrimack,33013,151391,32777,90341,28273,118614
New Hampshire,Rockingham,33015,309769,65101,187135,57533,244668
New Hampshire,Strafford,33017,130633,29953,80507,20173,100680
New Hampshire,Sullivan,33019,43146,8781,24834,9531,34365
New Jersey,Atlantic,34001,263670,62215,152428,49027,201455
New Jersey,Bergen,34003,932202,217438,550096,164668,714764
New Jersey,Burlington,34005,445349,101603,266381,77365,343746
New Jersey,Camden,34007,506471,125440,299501,81530,381031
New Jersey,Cape May,34009,92039,17731,49142,25166,74308
New Jersey,Cumberland,34011,149527,38908,87227,23392,110619
New Jersey,Essex,34013,798975,208554,479319,111102,590421
New Jersey,Gloucester,34015,291636,70129,173935,47572,221507
New Jersey,Hudson,34017,672391,149409,441075,81907,522982
New Jersey,Hunterdon,34019,124371,26684,73601,24086,97687
New Jersey,Mercer,34021,367430,91109,218834,57487,276321
New Jersey,Middlesex,34023,825062,202404,494895,127763,622658
New Jersey,Monmouth,34025,618795,144083,362214,112498,474712
New Jersey,Morris,34027,491845,114698,290661,86486,377147
New Jersey,Ocean,34029,607186,158601,310257,138328,448585
New Jersey,Passaic,34031,501826,132995,293651,75180,368831
New Jersey,Salem,34033,62385,14661,35853,11871,47724
New Jersey,Somerset,34035,328934,78489,197257,53188,250445
New Jersey,Sussex,34037,140488,30321,84927,25240,110167
New Jersey,Union,34039,556341,143094,331280,81967,413247
New Jersey,Warren,34041,105267,22921,62634,19712,82346
New Mexico,Bernalillo,35001,679121,162032,402187,114902,517089
New Mexico,Catron,35003,3527,462,1539,1526,3065
New Mexico,Chaves,35005,64615,18879,35302,10434,45736
New Mexico,Cibola,35006,26675,6835,15371,4469,19840
New Mexico,Colfax,35007,11941,2356,6318,3267,9585
New Mexico,Curry,35009,48954,14227,28437,6290,34727
New Mexico,De Baca,35011,1748,434,813,501,1314
New Mexico,Do??a Ana,35013,218195,61144,121637,35414,157051
New Mexico,Eddy,35015,58460,16947,32978,8535,41513
New Mexico,Grant,35017,26998,5928,13350,7720,21070
New Mexico,Guadalupe,35019,4300,992,2455,853,3308
New Mexico,Harding,35021,625,75,305,245,550
New Mexico,Hidalgo,35023,4198,1043,2212,943,3155
New Mexico,Lea,35025,71070,23246,39748,8076,47824
New Mexico,Lincoln,35027,19572,3946,9909,5717,15626
New Mexico,Los Alamos,35028,19369,4667,11199,3503,14702
New Mexico,Luna,35029,23709,6780,11897,5032,16929
New Mexico,McKinley,35031,71367,22195,39972,9200,49172
New Mexico,Mora,35033,4521,892,2322,1307,3629
New Mexico,Otero,35035,67490,17004,38799,11687,50486
New Mexico,Quay,35037,8253,1943,4188,2122,6310
New Mexico,Rio Arriba,35039,38921,9949,21158,7814,28972
New Mexico,Roosevelt,35041,18500,5392,10393,2715,13108
New Mexico,Sandoval,35043,146748,37070,82588,27090,109678
New Mexico,San Juan,35045,123958,35413,69148,19397,88545
New Mexico,San Miguel,35047,27277,5672,15438,6167,21605
New Mexico,Santa Fe,35049,150358,29484,82768,38106,120874
New Mexico,Sierra,35051,10791,1852,4900,4039,8939
New Mexico,Socorro,35053,16637,4355,8946,3336,12282
New Mexico,Taos,35055,32723,6338,17371,9014,26385
New Mexico,Torrance,35057,15461,3505,8637,3319,11956
New Mexico,Union,35059,4059,828,2344,887,3231
New Mexico,Valencia,35061,76688,19827,42882,13979,56861
New York,Albany,36001,305506,68022,184212,53272,237484
New York,Allegany,36003,46091,11895,25141,9055,34196
New York,Bronx County,36005,1418207,386338,843103,188766,1031869
New York,Broome,36007,190488,44888,108620,36980,145600
New York,Cattaraugus,36009,76117,18780,42315,15022,57337
New York,Cayuga,36011,76576,16595,44792,15189,59981
New York,Chautauqua,36013,126903,29766,70852,26285,97137
New York,Chemung,36015,83456,19638,47534,16284,63818
New York,Chenango,36017,47207,10680,26677,9850,36527
New York,Clinton,36019,80485,17415,48849,14221,63070
New York,Columbia,36021,59461,11156,33805,14500,48305
New York,Cortland,36023,47581,11947,27599,8035,35634
New York,Delaware,36025,44135,8841,24178,11116,35294
New York,Dutchess,36027,294218,64786,176033,53399,229432
New York,Erie,36029,918702,209453,540314,168935,709249
New York,Essex,36031,36885,6573,21363,8949,30312
New York,Franklin,36033,50022,10917,30380,8725,39105
New York,Fulton,36035,53383,11805,30826,10752,41578
New York,Genesee,36037,57280,12935,33295,11050,44345
New York,Greene,36039,47188,8796,27667,10725,38392
New York,Hamilton,36041,4416,662,2347,1407,3754
New York,Herkimer,36043,61319,14134,34168,13017,47185
New York,Jefferson,36045,109834,28847,65376,15611,80987
New York,Kings County,36047,2559903,629964,1562055,367884,1929939
New York,Lewis,36049,26296,6550,14746,5000,19746
New York,Livingston,36051,62914,14165,37213,11536,48749
New York,Madison,36053,70941,16902,40645,13394,54039
New York,Monroe,36055,741770,175546,433729,132495,566224
New York,Montgomery,36057,49221,12322,27590,9309,36899
New York,Nassau,36059,1356924,323627,786607,246690,1033297
New York,New York County,36061,1628706,266644,1085941,276121,1362062
New York,Niagara,36063,209281,46593,121828,40860,162688
New York,Oneida,36065,228671,55129,129698,43844,173542
New York,Onondaga,36067,460528,112232,267548,80748,348296
New York,Ontario,36069,109777,24803,62353,22621,84974
New York,Orange,36071,384940,109564,220239,55137,275376
New York,Orleans,36073,40352,8758,24160,7434,31594
New York,Oswego,36075,117124,28621,68817,19686,88503
New York,Otsego,36077,59493,12723,33834,12936,46770
New York,Putnam,36079,98320,21315,59277,17728,77005
New York,Queens County,36081,2253858,494209,1391316,368333,1759649
New York,Rensselaer,36083,158714,35700,95209,27805,123014
New York,Richmond County,36085,476143,114426,282416,79301,361717
New York,Rockland,36087,325789,101065,172955,51769,224724
New York,St. Lawrence,36089,107740,26932,61449,19359,80808
New York,Saratoga,36091,229863,50598,136033,43232,179265
New York,Schenectady,36093,155299,37428,90928,26943,117871
New York,Schoharie,36095,30999,6570,17382,7047,24429
New York,Schuyler,36097,17807,3665,10232,3910,14142
New York,Seneca,36099,34016,7458,19881,6677,26558
New York,Steuben,36101,95379,22318,53850,19211,73061
New York,Suffolk,36103,1476601,345983,874677,255941,1130618
New York,Sullivan,36105,75432,17577,43276,14579,57855
New York,Tioga,36107,48203,10938,27171,10094,37265
New York,Tompkins,36109,102180,23665,63085,15430,78515
New York,Ulster,36111,177573,35806,105584,36183,141767
New York,Warren,36113,63944,12746,36524,14674,51198
New York,Washington,36115,61204,12646,36270,12288,48558
New York,Wayne,36117,89918,20852,51514,17552,69066
New York,Westchester,36119,967506,235618,563377,168511,731888
New York,Wyoming,36121,39859,8150,24286,7423,31709
New York,Yates,36123,24913,6319,13278,5316,18594
North Carolina,Alamance,37001,169509,44019,96455,29035,125490
North Carolina,Alexander,37003,37497,8181,21649,7667,29316
North Carolina,Alleghany,37005,11137,2090,5931,3116,9047
North Carolina,Anson,37007,24446,5365,14351,4730,19081
North Carolina,Ashe,37009,27203,5189,14765,7249,22014
North Carolina,Avery,37011,17557,3073,10464,4020,14484
North Carolina,Beaufort,37013,46994,10298,25158,11538,36696
North Carolina,Bertie,37015,18947,3649,10819,4479,15298
North Carolina,Bladen,37017,32722,7327,17936,7459,25395
North Carolina,Brunswick,37019,142820,23111,73104,46605,119709
North Carolina,Buncombe,37021,261191,53138,154559,53494,208053
North Carolina,Burke,37023,90485,19060,52705,18720,71425
North Carolina,Cabarrus,37025,216453,60205,127184,29064,156248
North Carolina,Caldwell,37027,82178,18046,47363,16769,64132
North Carolina,Camden,37029,10867,2695,6339,1833,8172
North Carolina,Carteret,37031,69473,13207,38399,17867,56266
North Carolina,Caswell,37033,22604,4659,12940,5005,17945
North Carolina,Catawba,37035,159551,38837,91558,29156,120714
North Carolina,Chatham,37037,74470,16258,39578,18634,58212
North Carolina,Cherokee,37039,28612,5206,14683,8723,23406
North Carolina,Chowan,37041,13943,3081,7341,3521,10862
North Carolina,Clay,37043,11231,2075,5575,3581,9156
North Carolina,Cleveland,37045,97947,24022,55350,18575,73925
North Carolina,Columbus,37047,55508,12725,31364,11419,42783
North Carolina,Craven,37049,102139,24287,57749,20103,77852
North Carolina,Cumberland,37051,335509,93231,201341,40937,242278
North Carolina,Currituck,37053,27763,6659,16553,4551,21104
North Carolina,Dare,37055,37009,7591,21217,8201,29418
North Carolina,Davidson,37057,167609,39935,96585,31089,127674
North Carolina,Davie,37059,42846,9867,23700,9279,32979
North Carolina,Duplin,37061,58741,15404,31932,11405,43337
North Carolina,Durham,37063,321488,76150,201574,43764,245338
North Carolina,Edgecombe,37065,51472,12702,28261,10509,38770
North Carolina,Forsyth,37067,382295,98880,220695,62720,283415
North Carolina,Franklin,37069,69685,16920,40830,11935,52765
North Carolina,Gaston,37071,224529,55410,132468,36651,169119
North Carolina,Gates,37073,11562,2567,6577,2418,8995
North Carolina,Graham,37075,8441,1867,4507,2067,6574
North Carolina,Granville,37077,60443,13857,35912,10674,46586
North Carolina,Greene,37079,21069,4620,12857,3592,16449
North Carolina,Guilford,37081,537174,139362,314370,83442,397812
North Carolina,Halifax,37083,50010,11684,27636,10690,38326
North Carolina,Harnett,37085,135976,38802,79716,17458,97174
North Carolina,Haywood,37087,62317,12398,34347,15572,49919
North Carolina,Henderson,37089,117417,24070,62386,30961,93347
North Carolina,Hertford,37091,23677,5415,13426,4836,18262
North Carolina,Hoke,37093,55234,16155,33225,5854,39079
North Carolina,Hyde,37095,4937,932,2891,1114,4005
North Carolina,Iredell,37097,181806,45409,106884,29513,136397
North Carolina,Jackson,37099,43938,10177,25002,8759,33761
North Carolina,Johnston,37101,209339,57558,123223,28558,151781
North Carolina,Jones,37103,9419,1895,5267,2257,7524
North Carolina,Lee,37105,61779,16069,35306,10404,45710
North Carolina,Lenoir,37107,55949,13771,30875,11303,42178
North Carolina,Lincoln,37109,86111,19920,50735,15456,66191
North Carolina,McDowell,37111,45756,10053,26186,9517,35703
North Carolina,Macon,37113,35858,7275,18233,10350,28583
North Carolina,Madison,37115,21755,4539,12182,5034,17216
North Carolina,Martin,37117,22440,4972,12096,5372,17468
North Carolina,Mecklenburg,37119,1110356,286607,696063,127686,823749
North Carolina,Mitchell,37121,14964,2990,8164,3810,11974
North Carolina,Montgomery,37123,27173,6561,14869,5743,20612
North Carolina,Moore,37125,100880,23398,53290,24192,77482
North Carolina,Nash,37127,94298,23019,53323,17956,71279
North Carolina,New Hanover,37129,234473,50780,140546,43147,183693
North Carolina,Northampton,37131,19483,3701,10526,5256,15782
North Carolina,Onslow,37133,197938,56869,122043,19026,141069
North Carolina,Orange,37135,148476,37679,89143,21654,110797
North Carolina,Pamlico,37137,12726,2094,6766,3866,10632
North Carolina,Pasquotank,37139,39824,9937,23046,6841,29887
North Carolina,Pender,37141,63060,15292,36052,11716,47768
North Carolina,Perquimans,37143,13463,2742,7050,3671,10721
North Carolina,Person,37145,39490,8964,22588,7938,30526
North Carolina,Pitt,37147,180742,46632,109065,25045,134110
North Carolina,Polk,37149,20724,3622,10458,6644,17102
North Carolina,Randolph,37151,143667,35209,82398,26060,108458
North Carolina,Richmond,37153,44829,11379,25267,8183,33450
North Carolina,Robeson,37155,130625,36559,73501,20565,94066
North Carolina,Rockingham,37157,91010,20223,51791,18996,70787
North Carolina,Rowan,37159,142088,34875,81842,25371,107213
North Carolina,Rutherford,37161,67029,15071,37103,14855,51958
North Carolina,Sampson,37163,63531,17000,34894,11637,46531
North Carolina,Scotland,37165,34823,8904,19388,6531,25919
North Carolina,Stanly,37167,62806,15003,35680,12123,47803
North Carolina,Stokes,37169,45591,9313,26361,9917,36278
North Carolina,Surry,37171,71783,16546,40273,14964,55237
North Carolina,Swain,37173,14271,3462,8006,2803,10809
North Carolina,Transylvania,37175,34385,6089,17487,10809,28296
North Carolina,Tyrrell,37177,4016,796,2410,810,3220
North Carolina,Union,37179,239859,70994,137631,31234,168865
North Carolina,Vance,37181,44535,11561,24487,8487,32974
North Carolina,Wake,37183,1111761,293885,684012,133864,817876
North Carolina,Warren,37185,19731,3893,10665,5173,15838
North Carolina,Washington,37187,11580,2549,6099,2932,9031
North Carolina,Watauga,37189,56177,11895,35053,9229,44282
North Carolina,Wayne,37191,123131,32207,70122,20802,90924
North Carolina,Wilkes,37193,68412,15247,38003,15162,53165
North Carolina,Wilson,37195,81801,20688,45776,15337,61113
North Carolina,Yadkin,37197,37667,8639,21317,7711,29028
North Carolina,Yancey,37199,18069,3644,9681,4744,14425
North Dakota,Adams,38001,2216,471,1113,632,1745
North Dakota,Barnes,38003,10415,2363,5632,2420,8052
North Dakota,Benson,38005,6832,2572,3276,984,4260
North Dakota,Billings,38007,928,204,513,211,724
North Dakota,Bottineau,38009,6282,1526,3215,1541,4756
North Dakota,Bowman,38011,3024,791,1562,671,2233
North Dakota,Burke,38013,2115,566,1100,449,1549
North Dakota,Burleigh,38015,95626,24926,54841,15859,70700
North Dakota,Cass,38017,181923,46608,112643,22672,135315
North Dakota,Cavalier,38019,3762,910,1821,1031,2852
North Dakota,Dickey,38021,4872,1334,2529,1009,3538
North Dakota,Divide,38023,2264,563,1127,574,1701
North Dakota,Dunn,38025,4424,1180,2530,714,3244
North Dakota,Eddy,38027,2287,586,1160,541,1701
North Dakota,Emmons,38029,3241,698,1632,911,2543
North Dakota,Foster,38031,3210,751,1732,727,2459
North Dakota,Golden Valley,38033,1761,403,907,451,1358
North Dakota,Grand Forks,38035,69451,17490,42712,9249,51961
North Dakota,Grant,38037,2274,498,1080,696,1776
North Dakota,Griggs,38039,2231,495,1060,676,1736
North Dakota,Hettinger,38041,2499,677,1271,551,1822
North Dakota,Kidder,38043,2480,562,1287,631,1918
North Dakota,LaMoure,38045,4046,949,1984,1113,3097
North Dakota,Logan,38047,1850,454,904,492,1396
North Dakota,McHenry,38049,5745,1482,3061,1202,4263
North Dakota,McIntosh,38051,2497,498,1196,803,1999
North Dakota,McKenzie,38053,15024,5113,8585,1326,9911
North Dakota,McLean,38055,9450,2227,4932,2291,7223
North Dakota,Mercer,38057,8187,2052,4493,1642,6135
North Dakota,Morton,38059,31364,7782,18263,5319,23582
North Dakota,Mountrail,38061,10545,3142,6178,1225,7403
North Dakota,Nelson,38063,2879,602,1513,764,2277
North Dakota,Oliver,38065,1959,533,982,444,1426
North Dakota,Pembina,38067,6801,1528,3651,1622,5273
North Dakota,Pierce,38069,3975,975,2055,945,3000
North Dakota,Ramsey,38071,11519,2975,6206,2338,8544
North Dakota,Ransom,38073,5218,1271,2840,1107,3947
North Dakota,Renville,38075,2327,557,1287,483,1770
North Dakota,Richland,38077,16177,4216,8940,3021,11961
North Dakota,Rolette,38079,14176,5158,7288,1730,9018
North Dakota,Sargent,38081,3898,909,2106,883,2989
North Dakota,Sheridan,38083,1315,257,610,448,1058
North Dakota,Sioux,38085,4230,1676,2195,359,2554
North Dakota,Slope,38087,750,162,410,178,588
North Dakota,Stark,38089,31489,9143,17974,4372,22346
North Dakota,Steele,38091,1890,443,971,476,1447
North Dakota,Stutsman,38093,20704,4719,11856,4129,15985
North Dakota,Towner,38095,2189,501,1135,553,1688
North Dakota,Traill,38097,8036,2061,4369,1606,5975
North Dakota,Walsh,38099,10641,2678,5671,2292,7963
North Dakota,Ward,38101,67641,17881,40835,8925,49760
North Dakota,Wells,38103,3834,858,1875,1101,2976
North Dakota,Williams,38105,37589,11801,22332,3456,25788
Ohio,Adams,39001,27698,7213,15373,5112,20485
Ohio,Allen,39003,102351,26543,57299,18509,75808
Ohio,Ashland,39005,53484,13803,29439,10242,39681
Ohio,Ashtabula,39007,97241,23419,54736,19086,73822
Ohio,Athens,39009,65327,16041,40371,8915,49286
Ohio,Auglaize,39011,45656,11979,25031,8646,33677
Ohio,Belmont,39013,67006,13836,38832,14338,53170
Ohio,Brown,39015,43432,10841,24624,7967,32591
Ohio,Butler,39017,383134,102997,222173,57964,280137
Ohio,Carroll,39019,26914,6183,14916,5815,20731
Ohio,Champaign,39021,38885,9594,22103,7188,29291
Ohio,Clark,39023,134083,33646,73974,26463,100437
Ohio,Clermont,39025,206428,51249,120269,34910,155179
Ohio,Clinton,39027,41968,10711,23888,7369,31257
Ohio,Columbiana,39029,101883,22607,57708,21568,79276
Ohio,Coshocton,39031,36600,9487,19858,7255,27113
Ohio,Crawford,39033,41494,9824,22799,8871,31670
Ohio,Cuyahoga,39035,1235072,283213,721657,230202,951859
Ohio,Darke,39037,51113,13219,27706,10188,37894
Ohio,Defiance,39039,38087,9651,21116,7320,28436
Ohio,Delaware,39041,209177,59625,119968,29584,149552
Ohio,Erie,39043,74266,16495,41023,16748,57771
Ohio,Fairfield,39045,157574,41296,90938,25340,116278
Ohio,Fayette,39047,28525,7247,16062,5216,21278
Ohio,Franklin,39049,1316756,342763,810850,163143,973993
Ohio,Fulton,39051,42126,10847,23512,7767,31279
Ohio,Gallia,39053,29898,7533,16599,5766,22365
Ohio,Geauga,39055,93649,23340,50506,19803,70309
Ohio,Greene,39057,168937,40957,98344,29636,127980
Ohio,Guernsey,39059,38875,9334,21739,7802,29541
Ohio,Hamilton,39061,817473,211050,477748,128675,606423
Ohio,Hancock,39063,75783,18835,43549,13399,56948
Ohio,Hardin,39065,31365,8635,17618,5112,22730
Ohio,Harrison,39067,15040,3418,8342,3280,11622
Ohio,Henry,39069,27006,6840,14999,5167,20166
Ohio,Highland,39071,43161,11129,23864,8168,32032
Ohio,Hocking,39073,28264,6774,15988,5502,21490
Ohio,Holmes,39075,43960,14748,23056,6156,29212
Ohio,Huron,39077,58266,15302,32685,10279,42964
Ohio,Jackson,39079,32413,8452,18243,5718,23961
Ohio,Jefferson,39081,65325,14316,36590,14419,51009
Ohio,Knox,39083,62322,16423,34300,11599,45899
Ohio,Lake,39085,230149,50358,132420,47371,179791
Ohio,Lawrence,39087,59463,14052,34028,11383,45411
Ohio,Licking,39089,176862,45386,101832,29644,131476
Ohio,Logan,39091,45672,11493,25622,8557,34179
Ohio,Lorain,39093,309833,75443,176194,58196,234390
Ohio,Lucas,39095,428348,108973,247833,71542,319375
Ohio,Madison,39097,44731,10011,27622,7098,34720
Ohio,Mahoning,39099,228683,51054,128618,49011,177629
Ohio,Marion,39101,65093,15008,38224,11861,50085
Ohio,Medina,39103,179746,43554,103004,33188,136192
Ohio,Meigs,39105,22907,5336,12889,4682,17571
Ohio,Mercer,39107,41172,11556,22117,7499,29616
Ohio,Miami,39109,106987,26809,59923,20255,80178
Ohio,Monroe,39111,13654,3003,7357,3294,10651
Ohio,Montgomery,39113,531687,130399,303855,97433,401288
Ohio,Morgan,39115,14508,3289,8044,3175,11219
Ohio,Morrow,39117,35328,8704,20329,6295,26624
Ohio,Muskingum,39119,86215,21387,49129,15699,64828
Ohio,Noble,39121,14424,2903,7441,4080,11521
Ohio,Ottawa,39123,40525,8104,21878,10543,32421
Ohio,Paulding,39125,18672,4803,10308,3561,13869
Ohio,Perry,39127,36134,9240,20754,6140,26894
Ohio,Pickaway,39129,58457,13823,35290,9344,44634
Ohio,Pike,39131,27772,7119,15590,5063,20653
Ohio,Portage,39133,162466,37421,97385,27660,125045
Ohio,Preble,39135,40882,9978,22814,8090,30904
Ohio,Putnam,39137,33861,9346,18419,6096,24515
Ohio,Richland,39139,121154,28845,68369,23940,92309
Ohio,Ross,39141,76666,17806,45721,13139,58860
Ohio,Sandusky,39143,58518,14237,32969,11312,44281
Ohio,Scioto,39145,75314,18211,43073,14030,57103
Ohio,Seneca,39147,55178,13966,30950,10262,41212
Ohio,Shelby,39149,48590,13129,27187,8274,35461
Ohio,Stark,39151,370606,87924,208806,73876,282682
Ohio,Summit,39153,541013,125033,315901,100079,415980
Ohio,Trumbull,39155,197974,44221,110072,43681,153753
Ohio,Tuscarawas,39157,91987,22974,50649,18364,69013
Ohio,Union,39159,58988,15780,35727,7481,43208
Ohio,Van Wert,39161,28275,7151,15626,5498,21124
Ohio,Vinton,39163,13085,3121,7534,2430,9964
Ohio,Warren,39165,234602,62451,137206,34945,172151
Ohio,Washington,39167,59911,13283,33686,12942,46628
Ohio,Wayne,39169,115710,31398,63130,21182,84312
Ohio,Williams,39171,36692,9098,20534,7060,27594
Ohio,Wood,39173,130817,32921,77371,20525,97896
Ohio,Wyandot,39175,21772,5357,12082,4333,16415
Oklahoma,Adair,40001,22194,6521,12158,3515,15673
Oklahoma,Alfalfa,40003,5702,1191,3356,1155,4511
Oklahoma,Atoka,40005,13758,3376,7628,2754,10382
Oklahoma,Beaver,40007,5311,1519,2741,1051,3792
Oklahoma,Beckham,40009,21859,5918,12726,3215,15941
Oklahoma,Blaine,40011,9429,2605,4916,1908,6824
Oklahoma,Bryan,40013,47995,12532,26818,8645,35463
Oklahoma,Caddo,40015,28762,7848,16053,4861,20914
Oklahoma,Canadian,40017,148306,41829,86763,19714,106477
Oklahoma,Carter,40019,48111,13042,26787,8282,35069
Oklahoma,Cherokee,40021,48657,12418,27975,8264,36239
Oklahoma,Choctaw,40023,14672,3863,7712,3097,10809
Oklahoma,Cimarron,40025,2137,590,1004,543,1547
Oklahoma,Cleveland,40027,284014,70558,174267,39189,213456
Oklahoma,Coal,40029,5495,1413,2929,1153,4082
Oklahoma,Comanche,40031,120749,32636,72519,15594,88113
Oklahoma,Cotton,40033,5666,1379,3124,1163,4287
Oklahoma,Craig,40035,14142,3346,7951,2845,10796
Oklahoma,Creek,40037,71522,18397,40078,13047,53125
Oklahoma,Custer,40039,29003,8386,16518,4099,20617
Oklahoma,Delaware,40041,43009,9511,22681,10817,33498
Oklahoma,Dewey,40043,4891,1449,2554,888,3442
Oklahoma,Ellis,40045,3859,952,2012,895,2907
Oklahoma,Garfield,40047,61056,17001,34000,10055,44055
Oklahoma,Garvin,40049,27711,7495,15166,5050,20216
Oklahoma,Grady,40051,55834,14576,31921,9337,41258
Oklahoma,Grant,40053,4333,1133,2233,967,3200
Oklahoma,Greer,40055,5712,1257,3437,1018,4455
Oklahoma,Harmon,40057,2653,720,1400,533,1933
Oklahoma,Harper,40059,3688,1029,1936,723,2659
Oklahoma,Haskell,40061,12627,3239,6812,2576,9388
Oklahoma,Hughes,40063,13279,3191,7569,2519,10088
Oklahoma,Jackson,40065,24530,6701,14091,3738,17829
Oklahoma,Jefferson,40067,6002,1590,3124,1288,4412
Oklahoma,Johnston,40069,11085,2996,5898,2191,8089
Oklahoma,Kay,40071,43538,11977,23053,8508,31561
Oklahoma,Kingfisher,40073,15765,4610,8576,2579,11155
Oklahoma,Kiowa,40075,8708,2295,4701,1712,6413
Oklahoma,Latimer,40077,10073,2536,5306,2231,7537
Oklahoma,Le Flore,40079,49853,13249,27500,9104,36604
Oklahoma,Lincoln,40081,34877,9006,19375,6496,25871
Oklahoma,Logan,40083,48011,12695,27448,7868,35316
Oklahoma,Love,40085,10253,2712,5534,2007,7541
Oklahoma,McClain,40087,40474,11212,22895,6367,29262
Oklahoma,McCurtain,40089,32832,9045,17691,6096,23787
Oklahoma,McIntosh,40091,19596,4200,10327,5069,15396
Oklahoma,Major,40093,7629,2145,3921,1563,5484
Oklahoma,Marshall,40095,16931,4273,8956,3702,12658
Oklahoma,Mayes,40097,41100,10505,22829,7766,30595
Oklahoma,Murray,40099,14073,3562,7674,2837,10511
Oklahoma,Muskogee,40101,67997,18440,37957,11600,49557
Oklahoma,Noble,40103,11131,2872,6032,2227,8259
Oklahoma,Nowata,40105,10076,2467,5616,1993,7609
Oklahoma,Okfuskee,40107,11993,3000,6841,2152,8993
Oklahoma,Oklahoma,40109,797434,222058,463547,111829,575376
Oklahoma,Okmulgee,40111,38465,10142,20998,7325,28323
Oklahoma,Osage,40113,46963,11069,26231,9663,35894
Oklahoma,Ottawa,40115,31127,8695,16683,5749,22432
Oklahoma,Pawnee,40117,16376,4199,8984,3193,12177
Oklahoma,Payne,40119,81784,20829,50307,10648,60955
Oklahoma,Pittsburg,40121,43654,10622,24150,8882,33032
Oklahoma,Pontotoc,40123,38284,10505,21424,6355,27779
Oklahoma,Pottawatomie,40125,72592,19139,41401,12052,53453
Oklahoma,Pushmataha,40127,11096,2657,5819,2620,8439
Oklahoma,Roger Mills,40129,3583,949,1847,787,2634
Oklahoma,Rogers,40131,92459,23682,53375,15402,68777
Oklahoma,Seminole,40133,24258,6666,13140,4452,17592
Oklahoma,Sequoyah,40135,41569,10600,23134,7835,30969
Oklahoma,Stephens,40137,43143,10845,23534,8764,32298
Oklahoma,Texas,40139,19983,6362,11260,2361,13621
Oklahoma,Tillman,40141,7250,1856,3927,1467,5394
Oklahoma,Tulsa,40143,651552,179360,375729,96463,472192
Oklahoma,Wagoner,40145,81289,21316,46322,13651,59973
Oklahoma,Washington,40147,51527,13438,27902,10187,38089
Oklahoma,Washita,40149,10916,2914,5964,2038,8002
Oklahoma,Woods,40151,8793,2249,5014,1530,6544
Oklahoma,Woodward,40153,20211,5335,11563,3313,14876
Oregon,Baker,41001,16124,3457,8401,4266,12667
Oregon,Benton,41003,93053,20809,56605,15639,72244
Oregon,Clackamas,41005,418187,97381,242349,78457,320806
Oregon,Clatsop,41007,40224,8383,22413,9428,31841
Oregon,Columbia,41009,52354,12003,30307,10044,40351
Oregon,Coos,41011,64487,12906,34488,17093,51581
Oregon,Crook,41013,24404,5249,13015,6140,19155
Oregon,Curry,41015,22925,3554,11346,8025,19371
Oregon,Deschutes,41017,197692,42815,114397,40480,154877
Oregon,Douglas,41019,110980,23413,58374,29193,87567
Oregon,Gilliam,41021,1912,399,985,528,1513
Oregon,Grant,41023,7199,1376,3564,2259,5823
Oregon,Harney,41025,7393,1627,3922,1844,5766
Oregon,Hood River,41027,23382,6098,13478,3806,17284
Oregon,Jackson,41029,220944,49830,121266,49848,171114
Oregon,Jefferson,41031,24658,6247,13523,4888,18411
Oregon,Josephine,41033,87487,18660,45764,23063,68827
Oregon,Klamath,41035,68238,16276,37176,14786,51962
Oregon,Lake,41037,7869,1656,4210,2003,6213
Oregon,Lane,41039,382067,81587,224306,76174,300480
Oregon,Lincoln,41041,49962,9121,26185,14656,40841
Oregon,Linn,41043,129749,31573,73434,24742,98176
Oregon,Malheur,41045,30571,8737,16694,5140,21834
Oregon,Marion,41047,347818,93545,197994,56279,254273
Oregon,Morrow,41049,11603,3486,6172,1945,8117
Oregon,Multnomah,41051,812855,165977,534001,112877,646878
Oregon,Polk,41053,86085,22139,48025,15921,63946
Oregon,Sherman,41055,1780,365,962,453,1415
Oregon,Tillamook,41057,27036,5568,14328,7140,21468
Oregon,Umatilla,41059,77950,21474,43966,12510,56476
Oregon,Union,41061,26835,6737,14332,5766,20098
Oregon,Wallowa,41063,7208,1472,3593,2143,5736
Oregon,Wasco,41065,26682,6431,14651,5600,20251
Oregon,Washington,41067,601592,148102,370129,83361,453490
Oregon,Wheeler,41069,1332,208,640,484,1124
Oregon,Yamhill,41071,107100,26819,61182,19099,80281
Pennsylvania,Adams,42001,103009,23331,57948,21730,79678
Pennsylvania,Allegheny,42003,1216045,258065,722701,235279,957980
Pennsylvania,Armstrong,42005,64735,13511,36595,14629,51224
Pennsylvania,Beaver,42007,163929,34769,93062,36098,129160
Pennsylvania,Bedford,42009,47888,10117,26550,11221,37771
Pennsylvania,Berks,42011,421164,106018,241027,74119,315146
Pennsylvania,Blair,42013,121829,27685,68209,25935,94144
Pennsylvania,Bradford,42015,60323,14334,32776,13213,45989
Pennsylvania,Bucks,42017,628270,140688,366793,120789,487582
Pennsylvania,Butler,42019,187853,42404,108980,36469,145449
Pennsylvania,Cambria,42021,130192,28574,71376,30242,101618
Pennsylvania,Cameron,42023,4447,876,2323,1248,3571
Pennsylvania,Carbon,42025,64182,13520,36718,13944,50662
Pennsylvania,Centre,42027,162385,35426,102825,24134,126959
Pennsylvania,Chester,42029,524989,132975,303663,88351,392014
Pennsylvania,Clarion,42031,38438,8827,21815,7796,29611
Pennsylvania,Clearfield,42033,79255,15770,46871,16614,63485
Pennsylvania,Clinton,42035,38632,9251,21979,7402,29381
Pennsylvania,Columbia,42037,64964,14457,37475,13032,50507
Pennsylvania,Crawford,42039,84629,19751,46915,17963,64878
Pennsylvania,Cumberland,42041,253370,59066,146554,47750,194304
Pennsylvania,Dauphin,42043,278299,68455,161424,48420,209844
Pennsylvania,Delaware,42045,566747,142037,329716,94994,424710
Pennsylvania,Elk,42047,29910,6337,16836,6737,23573
Pennsylvania,Erie,42049,269728,65604,153874,50250,204124
Pennsylvania,Fayette,42051,129274,27050,74167,28057,102224
Pennsylvania,Forest,42053,7247,925,4671,1651,6322
Pennsylvania,Franklin,42055,155027,37793,86065,31169,117234
Pennsylvania,Fulton,42057,14530,3154,8178,3198,11376
Pennsylvania,Greene,42059,36233,8084,21135,7014,28149
Pennsylvania,Huntingdon,42061,45144,9280,26225,9639,35864
Pennsylvania,Indiana,42063,84073,19237,48014,16822,64836
Pennsylvania,Jefferson,42065,43425,10150,23932,9343,33275
Pennsylvania,Juniata,42067,24763,6068,13582,5113,18695
Pennsylvania,Lackawanna,42069,209674,48593,118459,42622,161081
Pennsylvania,Lancaster,42071,545724,142503,302840,100381,403221
Pennsylvania,Lawrence,42073,85512,18995,47248,19269,66517
Pennsylvania,Lebanon,42075,141793,35618,78002,28173,106175
Pennsylvania,Lehigh,42077,369318,92912,213222,63184,276406
Pennsylvania,Luzerne,42079,317417,70759,182681,63977,246658
Pennsylvania,Lycoming,42081,113299,26277,64561,22461,87022
Pennsylvania,McKean,42083,40625,9203,23275,8147,31422
Pennsylvania,Mercer,42085,109424,24129,60972,24323,85295
Pennsylvania,Mifflin,42087,46138,11173,24784,10181,34965
Pennsylvania,Monroe,42089,170271,38823,101101,30347,131448
Pennsylvania,Montgomery,42091,830915,197528,482413,150974,633387
Pennsylvania,Montour,42093,18230,4080,10227,3923,14150
Pennsylvania,Northampton,42095,305285,69905,175755,59625,235380
Pennsylvania,Northumberland,42097,90843,19421,51616,19806,71422
Pennsylvania,Perry,42099,46272,10769,26697,8806,35503
Pennsylvania,Philadelphia,42101,1584064,386100,976286,221678,1197964
Pennsylvania,Pike,42103,55809,10896,31802,13111,44913
Pennsylvania,Potter,42105,16526,3666,8817,4043,12860
Pennsylvania,Schuylkill,42107,141359,30466,81571,29322,110893
Pennsylvania,Snyder,42109,40372,10075,22414,7883,30297
Pennsylvania,Somerset,42111,73447,14341,42230,16876,59106
Pennsylvania,Sullivan,42113,6066,803,3502,1761,5263
Pennsylvania,Susquehanna,42115,40328,8203,22330,9795,32125
Pennsylvania,Tioga,42117,40591,9171,22265,9155,31420
Pennsylvania,Union,42119,44923,10135,26447,8341,34788
Pennsylvania,Venango,42121,50668,10704,28263,11701,39964
Pennsylvania,Warren,42123,39191,8336,21639,9216,30855
Pennsylvania,Washington,42125,206865,45271,118053,43541,161594
Pennsylvania,Wayne,42127,51361,9296,29442,12623,42065
Pennsylvania,Westmoreland,42129,348899,70766,196870,81263,278133
Pennsylvania,Wyoming,42131,26794,5851,15081,5862,20943
Pennsylvania,York,42133,449058,109185,259246,80627,339873
Rhode Island,Bristol,44001,48479,10898,27786,9795,37581
Rhode Island,Kent,44003,164292,33588,98882,31822,130704
Rhode Island,Newport,44005,82082,16097,47298,18687,65985
Rhode Island,Providence,44007,638931,151517,387631,99783,487414
Rhode Island,Washington,44009,125577,26443,72175,26959,99134
South Carolina,Abbeville,45001,24527,5578,13466,5483,18949
South Carolina,Aiken,45003,170872,40516,96364,33992,130356
South Carolina,Allendale,45005,8688,1828,5042,1818,6860
South Carolina,Anderson,45007,202558,50879,114553,37126,151679
South Carolina,Bamberg,45009,14066,3276,7638,3152,10790
South Carolina,Barnwell,45011,20866,5431,11491,3944,15435
South Carolina,Beaufort,45013,192122,40343,97971,53808,151779
South Carolina,Berkeley,45015,227907,60170,135461,32276,167737
South Carolina,Calhoun,45017,14553,3008,8062,3483,11545
South Carolina,Charleston,45019,411406,90454,251126,69826,320952
South Carolina,Cherokee,45021,57300,14743,32751,9806,42557
South Carolina,Chester,45023,32244,7893,18167,6184,24351
South Carolina,Chesterfield,45025,45650,10997,25968,8685,34653
South Carolina,Clarendon,45027,33745,7203,18384,8158,26542
South Carolina,Colleton,45029,37677,9268,20606,7803,28409
South Carolina,Darlington,45031,66618,16376,37251,12991,50242
South Carolina,Dillon,45033,30479,8405,16846,5228,22074
South Carolina,Dorchester,45035,162809,42943,96222,23644,119866
South Carolina,Edgefield,45037,27260,5446,16512,5302,21814
South Carolina,Fairfield,45039,22347,4695,12639,5013,17652
South Carolina,Florence,45041,138293,35791,78440,24062,102502
South Carolina,Georgetown,45043,62680,12464,32276,17940,50216
South Carolina,Greenville,45045,523542,132613,306401,84528,390929
South Carolina,Greenwood,45047,70811,18070,39392,13349,52741
South Carolina,Hampton,45049,19222,4493,11120,3609,14729
South Carolina,Horry,45051,354081,70045,195227,88809,284036
South Carolina,Jasper,45053,30073,6539,17482,6052,23534
South Carolina,Kershaw,45055,66551,16787,37327,12437,49764
South Carolina,Lancaster,45057,98012,22861,54138,21013,75151
South Carolina,Laurens,45059,67493,16526,38273,12694,50967
South Carolina,Lee,45061,16828,3735,9783,3310,13093
South Carolina,Lexington,45063,298750,75152,175148,48450,223598
South Carolina,McCormick,45065,9463,1171,4921,3371,8292
South Carolina,Marion,45067,30657,7579,16726,6352,23078
South Carolina,Marlboro,45069,26118,5719,15538,4861,20399
South Carolina,Newberry,45071,38440,9462,21183,7795,28978
South Carolina,Oconee,45073,79546,17291,43512,18743,62255
South Carolina,Orangeburg,45075,86175,21554,47061,17560,64621
South Carolina,Pickens,45077,126884,31097,74547,21240,95787
South Carolina,Richland,45079,415759,106620,254282,54857,309139
South Carolina,Saluda,45081,20473,4757,11560,4156,15716
South Carolina,Spartanburg,45083,319785,82359,184939,52487,237426
South Carolina,Sumter,45085,106721,28006,60727,17988,78715
South Carolina,Union,45087,27316,6314,15370,5632,21002
South Carolina,Williamsburg,45089,30368,6897,16867,6604,23471
South Carolina,York,45091,280979,74485,165092,41402,206494
South Dakota,Aurora,46003,2751,743,1439,569,2008
South Dakota,Beadle,46005,18453,5384,9789,3280,13069
South Dakota,Bennett,46007,3365,1226,1692,447,2139
South Dakota,Bon Homme,46009,6901,1450,4017,1434,5451
South Dakota,Brookings,46011,35077,9985,20715,4377,25092
South Dakota,Brown,46013,38839,10241,21639,6959,28598
South Dakota,Brule,46015,5297,1490,2763,1044,3807
South Dakota,Buffalo,46017,1962,819,995,148,1143
South Dakota,Butte,46019,10429,2801,5485,2143,7628
South Dakota,Campbell,46021,1376,252,721,403,1124
South Dakota,Charles Mix,46023,9292,2997,4568,1727,6295
South Dakota,Clark,46025,3736,1057,1864,815,2679
South Dakota,Clay,46027,14070,3713,8585,1772,10357
South Dakota,Codington,46029,28009,7232,15642,5135,20777
South Dakota,Corson,46031,4086,1608,1988,490,2478
South Dakota,Custer,46033,8972,1448,4684,2840,7524
South Dakota,Davison,46035,19775,5122,10871,3782,14653
South Dakota,Day,46037,5424,1309,2694,1421,4115
South Dakota,Deuel,46039,4351,1093,2299,959,3258
South Dakota,Dewey,46041,5892,2416,2890,586,3476
South Dakota,Douglas,46043,2921,837,1382,702,2084
South Dakota,Edmunds,46045,3829,955,2031,843,2874
South Dakota,Fall River,46047,6713,1252,3454,2007,5461
South Dakota,Faulk,46049,2299,628,1128,543,1671
South Dakota,Grant,46051,7052,1734,3809,1509,5318
South Dakota,Gregory,46053,4185,1077,2030,1078,3108
South Dakota,Haakon,46055,1899,479,939,481,1420
South Dakota,Hamlin,46057,6164,2154,3057,953,4010
South Dakota,Hand,46059,3191,741,1629,821,2450
South Dakota,Hanson,46061,3453,1134,1783,536,2319
South Dakota,Harding,46063,1298,338,724,236,960
South Dakota,Hughes,46065,17526,4580,9788,3158,12946
South Dakota,Hutchinson,46067,7291,1991,3630,1670,5300
South Dakota,Hyde,46069,1301,302,673,326,999
South Dakota,Jackson,46071,3344,1245,1648,451,2099
South Dakota,Jerauld,46073,2013,503,962,548,1510
South Dakota,Jones,46075,903,213,475,215,690
South Dakota,Kingsbury,46077,4939,1241,2538,1160,3698
South Dakota,Lake,46079,12797,3073,6695,3029,9724
South Dakota,Lawrence,46081,25844,5466,14461,5917,20378
South Dakota,Lincoln,46083,61128,18080,34863,8185,43048
South Dakota,Lyman,46085,3781,1200,1969,612,2581
South Dakota,McCook,46087,5586,1664,2865,1057,3922
South Dakota,McPherson,46089,2379,636,1069,674,1743
South Dakota,Marshall,46091,4935,1284,2604,1047,3651
South Dakota,Meade,46093,28332,6975,16827,4530,21357
South Dakota,Mellette,46095,2061,698,1058,305,1363
South Dakota,Miner,46097,2216,592,1159,465,1624
South Dakota,Minnehaha,46099,193134,53292,113801,26041,139842
South Dakota,Moody,46101,6576,1891,3424,1261,4685
South Dakota,Oglala Lakota,46102,14177,5678,7446,1053,8499
South Dakota,Pennington,46103,113775,28494,64197,21084,85281
South Dakota,Perkins,46105,2865,645,1460,760,2220
South Dakota,Potter,46107,2153,494,1031,628,1659
South Dakota,Roberts,46109,10394,3264,5078,2052,7130
South Dakota,Sanborn,46111,2344,630,1240,474,1714
South Dakota,Spink,46115,6376,1585,3440,1351,4791
South Dakota,Stanley,46117,3098,843,1624,631,2255
South Dakota,Sully,46119,1391,315,713,363,1076
South Dakota,Todd,46121,10177,4568,4846,763,5609
South Dakota,Tripp,46123,5441,1389,2814,1238,4052
South Dakota,Turner,46125,8384,2218,4374,1792,6166
South Dakota,Union,46127,15932,4221,8749,2962,11711
South Dakota,Walworth,46129,5435,1392,2722,1321,4043
South Dakota,Yankton,46135,22814,5316,13054,4444,17498
South Dakota,Ziebach,46137,2756,874,1618,264,1882
Tennessee,Anderson,47001,76978,17789,43590,15599,59189
Tennessee,Bedford,47003,49713,13726,28438,7549,35987
Tennessee,Benton,47005,16160,3504,8794,3862,12656
Tennessee,Bledsoe,47007,15064,2451,9774,2839,12613
Tennessee,Blount,47009,133088,29465,76251,27372,103623
Tennessee,Bradley,47011,108110,26638,62748,18724,81472
Tennessee,Campbell,47013,39842,8902,22578,8362,30940
Tennessee,Cannon,47015,14678,3411,8545,2722,11267
Tennessee,Carroll,47017,27767,6846,15188,5733,20921
Tennessee,Carter,47019,56391,11202,32574,12615,45189
Tennessee,Cheatham,47021,40667,9725,24624,6318,30942
Tennessee,Chester,47023,17297,4526,9786,2985,12771
Tennessee,Claiborne,47025,31959,6909,18573,6477,25050
Tennessee,Clay,47027,7615,1661,4031,1923,5954
Tennessee,Cocke,47029,36004,7924,20306,7774,28080
Tennessee,Coffee,47031,56520,14841,31842,9837,41679
Tennessee,Crockett,47033,14230,3638,7859,2733,10592
Tennessee,Cumberland,47035,60520,11381,30235,18904,49139
Tennessee,Davidson,47037,694144,161305,445816,87023,532839
Tennessee,Decatur,47039,11663,2639,6219,2805,9024
Tennessee,DeKalb,47041,20490,4804,11831,3855,15686
Tennessee,Dickson,47043,53948,13479,31479,8990,40469
Tennessee,Dyer,47045,37159,9658,20831,6670,27501
Tennessee,Fayette,47047,41133,8384,23671,9078,32749
Tennessee,Fentress,47049,18523,4169,10205,4149,14354
Tennessee,Franklin,47051,42208,9831,23788,8589,32377
Tennessee,Gibson,47053,49133,12910,27238,8985,36223
Tennessee,Giles,47055,29464,6813,16600,6051,22651
Tennessee,Grainger,47057,23320,5123,13317,4880,18197
Tennessee,Greene,47059,69069,14867,38947,15255,54202
Tennessee,Grundy,47061,13427,3135,7472,2820,10292
Tennessee,Hamblen,47063,64934,16365,36555,12014,48569
Tennessee,Hamilton,47065,367804,85187,216641,65976,282617
Tennessee,Hancock,47067,6620,1502,3679,1439,5118
Tennessee,Hardeman,47069,25050,5309,15091,4650,19741
Tennessee,Hardin,47071,25652,5719,13951,5982,19933
Tennessee,Hawkins,47073,56786,12212,32267,12307,44574
Tennessee,Haywood,47075,17304,4248,9641,3415,13056
Tennessee,Henderson,47077,28117,6936,15853,5328,21181
Tennessee,Henry,47079,32345,7222,17439,7684,25123
Tennessee,Hickman,47081,25178,5717,14946,4515,19461
Tennessee,Houston,47083,8201,1911,4585,1705,6290
Tennessee,Humphreys,47085,18582,4354,10467,3761,14228
Tennessee,Jackson,47087,11786,2306,6778,2702,9480
Tennessee,Jefferson,47089,54495,11895,31467,11133,42600
Tennessee,Johnson,47091,17788,3309,10333,4146,14479
Tennessee,Knox,47093,470313,112314,281963,76036,357999
Tennessee,Lake,47095,7016,1140,4701,1175,5876
Tennessee,Lauderdale,47097,25633,6266,15187,4180,19367
Tennessee,Lawrence,47099,44142,11967,24253,7922,32175
Tennessee,Lewis,47101,12268,2915,6740,2613,9353
Tennessee,Lincoln,47103,34366,8343,19268,6755,26023
Tennessee,Loudon,47105,54068,11305,28227,14536,42763
Tennessee,McMinn,47107,53794,12658,30435,10701,41136
Tennessee,McNairy,47109,25694,6097,14158,5439,19597
Tennessee,Macon,47111,24602,6522,14119,3961,18080
Tennessee,Madison,47113,97984,25193,55590,17201,72791
Tennessee,Marion,47115,28907,6660,16376,5871,22247
Tennessee,Marshall,47117,34375,8692,20062,5621,25683
Tennessee,Maury,47119,96387,24325,56318,15744,72062
Tennessee,Meigs,47121,12422,2753,6977,2692,9669
Tennessee,Monroe,47123,46545,10671,25895,9979,35874
Tennessee,Montgomery,47125,208993,61177,128056,19760,147816
Tennessee,Moore,47127,6488,1393,3664,1431,5095
Tennessee,Morgan,47129,21403,4459,12969,3975,16944
Tennessee,Obion,47131,30069,7129,16703,6237,22940
Tennessee,Overton,47133,22241,5192,12455,4594,17049
Tennessee,Perry,47135,8076,1946,4405,1725,6130
Tennessee,Pickett,47137,5048,949,2695,1404,4099
Tennessee,Polk,47139,16832,3567,9614,3651,13265
Tennessee,Putnam,47141,80245,19660,47126,13459,60585
Tennessee,Rhea,47143,33167,8311,18610,6246,24856
Tennessee,Roane,47145,53382,10977,30039,12366,42405
Tennessee,Robertson,47147,71813,18489,42300,11024,53324
Tennessee,Rutherford,47149,332285,91411,205052,35822,240874
Tennessee,Scott,47151,22068,5805,12471,3792,16263
Tennessee,Sequatchie,47153,15026,3412,8484,3130,11614
Tennessee,Sevier,47155,98250,21976,56302,19972,76274
Tennessee,Shelby,47157,937166,255641,550154,131371,681525
Tennessee,Smith,47159,20157,4937,11734,3486,15220
Tennessee,Stewart,47161,13715,3134,7748,2833,10581
Tennessee,Sullivan,47163,158348,33398,89765,35185,124950
Tennessee,Sumner,47165,191283,48840,111396,31047,142443
Tennessee,Tipton,47167,61599,16367,36043,9189,45232
Tennessee,Trousdale,47169,11284,2476,7345,1463,8808
Tennessee,Unicoi,47171,17883,3671,10048,4164,14212
Tennessee,Union,47173,19972,4675,11582,3715,15297
Tennessee,Van Buren,47175,5872,1263,3234,1375,4609
Tennessee,Warren,47177,41277,10511,23374,7392,30766
Tennessee,Washington,47179,129375,28461,76639,24275,100914
Tennessee,Wayne,47181,16673,3087,10271,3315,13586
Tennessee,Weakley,47183,33328,7802,19182,6344,25526
Tennessee,White,47185,27345,6514,15216,5615,20831
Tennessee,Williamson,47187,238412,70079,136144,32189,168333
Tennessee,Wilson,47189,144657,37188,84283,23186,107469
Texas,Anderson,48001,57735,12087,36990,8658,45648
Texas,Andrews,48003,18705,6323,10549,1833,12382
Texas,Angelina,48005,86715,24237,48056,14422,62478
Texas,Aransas,48007,23510,4588,12131,6791,18922
Texas,Archer,48009,8553,2029,4847,1677,6524
Texas,Armstrong,48011,1887,462,955,470,1425
Texas,Atascosa,48013,51153,15278,28270,7605,35875
Texas,Austin,48015,30032,7839,16260,5933,22193
Texas,Bailey,48017,7000,2367,3597,1036,4633
Texas,Bandera,48019,23112,4199,12474,6439,18913
Texas,Bastrop,48021,88723,24793,50065,13865,63930
Texas,Baylor,48023,3509,872,1793,844,2637
Texas,Bee,48025,32565,7786,20688,4091,24779
Texas,Bell,48027,362924,110277,212113,40534,252647
Texas,Bexar,48029,2003554,565620,1190091,247843,1437934
Texas,Blanco,48031,11931,2379,6548,3004,9552
Texas,Borden,48033,654,142,338,174,512
Texas,Bosque,48035,18685,4299,9645,4741,14386
Texas,Bowie,48037,93245,24090,53323,15832,69155
Texas,Brazoria,48039,374264,106958,221554,45752,267306
Texas,Brazos,48041,229211,61743,145775,21693,167468
Texas,Brewster,48043,9203,1861,5111,2231,7342
Texas,Briscoe,48045,1546,332,810,404,1214
Texas,Brooks,48047,7093,2137,3648,1308,4956
Texas,Brown,48049,37864,9244,20900,7720,28620
Texas,Burleson,48051,18443,4424,10152,3867,14019
Texas,Burnet,48053,48155,11167,25989,10999,36988
Texas,Caldwell,48055,43664,11670,25482,6512,31994
Texas,Calhoun,48057,21290,5621,11688,3981,15669
Texas,Callahan,48059,13943,3335,7650,2958,10608
Texas,Cameron,48061,423163,140542,224014,58607,282621
Texas,Camp,48063,13094,3746,6854,2494,9348
Texas,Carson,48065,5926,1514,3162,1250,4412
Texas,Cass,48067,30026,7305,15865,6856,22721
Texas,Castro,48069,7530,2368,3926,1236,5162
Texas,Chambers,48071,43837,13330,25248,5259,30507
Texas,Cherokee,48073,52646,14930,28272,9444,37716
Texas,Childress,48075,7306,1554,4587,1165,5752
Texas,Clay,48077,10471,2282,5705,2484,8189
Texas,Cochran,48079,2853,832,1553,468,2021
Texas,Coke,48081,3387,797,1643,947,2590
Texas,Coleman,48083,8175,1840,4216,2119,6335
Texas,Collin,48085,1034730,291011,627144,116575,743719
Texas,Collingsworth,48087,2920,800,1565,555,2120
Texas,Colorado,48089,21493,5446,11197,4850,16047
Texas,Comal,48091,156209,38518,89163,28528,117691
Texas,Comanche,48093,13635,3314,6991,3330,10321
Texas,Concho,48095,2726,549,1488,689,2177
Texas,Cooke,48097,41257,10698,22755,7804,30559
Texas,Coryell,48099,75951,19012,48899,8040,56939
Texas,Cottle,48101,1398,358,701,339,1040
Texas,Crane,48103,4797,1530,2673,594,3267
Texas,Crockett,48105,3464,938,1914,612,2526
Texas,Crosby,48107,5737,1655,2997,1085,4082
Texas,Culberson,48109,2171,535,1156,480,1636
Texas,Dallam,48111,7287,2523,3907,857,4764
Texas,Dallas,48113,2635516,749026,1594373,292117,1886490
Texas,Dawson,48115,12728,3626,7204,1898,9102
Texas,Deaf Smith,48117,18546,6296,9827,2423,12250
Texas,Delta,48119,5331,1381,2832,1118,3950
Texas,Denton,48121,887207,239747,553961,93499,647460
Texas,DeWitt,48123,20160,4962,11163,4035,15198
Texas,Dickens,48125,2211,468,1218,525,1743
Texas,Dimmit,48127,10124,3198,5177,1749,6926
Texas,Donley,48129,3278,842,1632,804,2436
Texas,Duval,48131,11157,3142,5984,2031,8015
Texas,Eastland,48133,18360,4608,9698,4054,13752
Texas,Ector,48135,166223,54911,95342,15970,111312
Texas,Edwards,48137,1932,458,913,561,1474
Texas,Ellis,48139,184826,53743,106795,24288,131083
Texas,El Paso,48141,839238,249839,484224,105175,589399
Texas,Erath,48143,42698,11948,24494,6256,30750
Texas,Falls,48145,17297,3974,10097,3226,13323
Texas,Fannin,48147,35514,8277,20649,6588,27237
Texas,Fayette,48149,25346,5548,13119,6679,19798
Texas,Fisher,48151,3830,897,1972,961,2933
Texas,Floyd,48153,5712,1660,2982,1070,4052
Texas,Foard,48155,1155,252,588,315,903
Texas,Fort Bend,48157,811688,242562,475275,93851,569126
Texas,Franklin,48159,10725,2721,5637,2367,8004
Texas,Freestone,48161,19717,4942,10779,3996,14775
Texas,Frio,48163,20306,5405,12402,2499,14901
Texas,Gaines,48165,21492,8393,11192,1907,13099
Texas,Galveston,48167,342139,91147,200005,50987,250992
Texas,Garza,48169,6229,1253,4257,719,4976
Texas,Gillespie,48171,26988,5868,13010,8110,21120
Texas,Glasscock,48173,1409,386,813,210,1023
Texas,Goliad,48175,7658,1753,4073,1832,5905
Texas,Gonzales,48177,20837,6122,11143,3572,14715
Texas,Gray,48179,21886,6021,12334,3531,15865
Texas,Grayson,48181,136212,35792,76238,24182,100420
Texas,Gregg,48183,123945,35155,69339,19451,88790
Texas,Grimes,48185,28880,7069,16677,5134,21811
Texas,Guadalupe,48187,166847,45879,97354,23614,120968
Texas,Hale,48189,33406,10046,18756,4604,23360
Texas,Hall,48191,2964,728,1525,711,2236
Texas,Hamilton,48193,8461,2004,4311,2146,6457
Texas,Hansford,48195,5399,1794,2793,812,3605
Texas,Hardeman,48197,3933,920,2101,912,3013
Texas,Hardin,48199,57602,15290,32550,9762,42312
Texas,Harris,48201,4713325,1367692,2831466,514167,3345633
Texas,Harrison,48203,66553,18280,36666,11607,48273
Texas,Hartley,48205,5576,1254,3461,861,4322
Texas,Haskell,48207,5658,1081,3311,1266,4577
Texas,Hays,48209,230191,62287,141717,26187,167904
Texas,Hemphill,48211,3819,1271,1942,606,2548
Texas,Henderson,48213,82737,19535,44668,18534,63202
Texas,Hidalgo,48215,868707,308514,461865,98328,560193
Texas,Hill,48217,36649,9422,19543,7684,27227
Texas,Hockley,48219,23021,6879,12689,3453,16142
Texas,Hood,48221,61643,14110,32117,15416,47533
Texas,Hopkins,48223,37084,9839,20358,6887,27245
Texas,Houston,48225,22968,4938,12854,5176,18030
Texas,Howard,48227,36664,9060,22791,4813,27604
Texas,Hudspeth,48229,4886,1114,2997,775,3772
Texas,Hunt,48231,98594,26515,56269,15810,72079
Texas,Hutchinson,48233,20938,5859,11498,3581,15079
Texas,Irion,48235,1536,376,832,328,1160
Texas,Jack,48237,8935,2169,5251,1515,6766
Texas,Jackson,48239,14760,4099,7941,2720,10661
Texas,Jasper,48241,35529,9183,19159,7187,26346
Texas,Jeff Davis,48243,2274,181,1281,812,2093
Texas,Jefferson,48245,251565,67182,146788,37595,184383
Texas,Jim Hogg,48247,5200,1738,2572,890,3462
Texas,Jim Wells,48249,40482,12211,21913,6358,28271
Texas,Johnson,48251,175817,49947,100719,25151,125870
Texas,Jones,48253,20083,3919,12976,3188,16164
Texas,Karnes,48255,15601,3726,9664,2211,11875
Texas,Kaufman,48257,136154,41427,78614,16113,94727
Texas,Kendall,48259,47431,12167,26112,9152,35264
Texas,Kenedy,48261,404,116,220,68,288
Texas,Kent,48263,762,184,377,201,578
Texas,Kerr,48265,52600,11330,26501,14769,41270
Texas,Kimble,48267,4337,867,2182,1288,3470
Texas,King,48269,272,74,147,51,198
Texas,Kinney,48271,3667,785,1972,910,2882
Texas,Kleberg,48273,30680,8919,17715,4046,21761
Texas,Knox,48275,3664,1048,1880,736,2616
Texas,Lamar,48277,49859,12910,27223,9726,36949
Texas,Lamb,48279,12893,3914,6739,2240,8979
Texas,Lampasas,48281,21428,5140,11966,4322,16288
Texas,La Salle,48283,7520,1689,4813,1018,5831
Texas,Lavaca,48285,20154,5135,10244,4775,15019
Texas,Lee,48287,17239,4187,9833,3219,13052
Texas,Leon,48289,17404,4266,8804,4334,13138
Texas,Liberty,48291,88219,26063,50757,11399,62156
Texas,Limestone,48293,23437,5759,13008,4670,17678
Texas,Lipscomb,48295,3233,894,1722,617,2339
Texas,Live Oak,48297,12207,2671,7003,2533,9536
Texas,Llano,48299,21795,3609,10067,8119,18186
Texas,Loving,48301,169,54,92,23,115
Texas,Lubbock,48303,310569,87857,183236,39476,222712
Texas,Lynn,48305,5951,1772,3205,974,4179
Texas,McCulloch,48307,7984,1944,4248,1792,6040
Texas,McLennan,48309,256623,73177,145718,37728,183446
Texas,McMullen,48311,743,161,393,189,582
Texas,Madison,48313,14284,3410,8610,2264,10874
Texas,Marion,48315,9854,1941,5216,2697,7913
Texas,Martin,48317,5771,1976,3136,659,3795
Texas,Mason,48319,4274,940,2084,1250,3334
Texas,Matagorda,48321,36643,10264,19988,6391,26379
Texas,Maverick,48323,58722,20232,31487,7003,38490
Texas,Medina,48325,51584,13317,29510,8757,38267
Texas,Menard,48327,2138,425,1014,699,1713
Texas,Midland,48329,176832,54552,103842,18438,122280
Texas,Milam,48331,24823,6472,13106,5245,18351
Texas,Mills,48333,4873,1092,2365,1416,3781
Texas,Mitchell,48335,8545,1984,5302,1259,6561
Texas,Montague,48337,19818,4867,10507,4444,14951
Texas,Montgomery,48339,607391,173183,352751,81457,434208
Texas,Moore,48341,20940,7190,11378,2372,13750
Texas,Morris,48343,12388,3114,6544,2730,9274
Texas,Motley,48345,1200,261,571,368,939
Texas,Nacogdoches,48347,65204,18954,36297,9953,46250
Texas,Navarro,48349,50113,14552,26910,8651,35561
Texas,Newton,48351,13595,2996,7721,2878,10599
Texas,Nolan,48353,14714,4265,7712,2737,10449
Texas,Nueces,48355,362294,98400,209825,54069,263894
Texas,Ochiltree,48357,9836,3328,5360,1148,6508
Texas,Oldham,48359,2112,534,1262,316,1578
Texas,Orange,48361,83396,22415,47252,13729,60981
Texas,Palo Pinto,48363,29189,7392,15904,5893,21797
Texas,Panola,48365,23194,6020,12585,4589,17174
Texas,Parker,48367,142878,38659,81888,22331,104219
Texas,Parmer,48369,9605,2979,5260,1366,6626
Texas,Pecos,48371,15823,4272,9410,2141,11551
Texas,Polk,48373,51353,11193,30427,9733,40160
Texas,Potter,48375,117415,34818,67394,15203,82597
Texas,Presidio,48377,6704,1956,3147,1601,4748
Texas,Rains,48379,12514,2750,6641,3123,9764
Texas,Randall,48381,137713,36931,79358,21424,100782
Texas,Reagan,48383,3849,1219,2203,427,2630
Texas,Real,48385,3452,623,1776,1053,2829
Texas,Red River,48387,12023,2587,6392,3044,9436
Texas,Reeves,48389,15976,3988,10110,1878,11988
Texas,Refugio,48391,6948,1706,3625,1617,5242
Texas,Roberts,48393,854,225,436,193,629
Texas,Robertson,48395,17074,4414,9248,3412,12660
Texas,Rockwall,48397,104915,30717,60803,13395,74198
Texas,Runnels,48399,10264,2617,5494,2153,7647
Texas,Rusk,48401,54406,13338,31871,9197,41068
Texas,Sabine,48403,10542,2090,5185,3267,8452
Texas,San Augustine,48405,8237,1756,4254,2227,6481
Texas,San Jacinto,48407,28859,6715,15656,6488,22144
Texas,San Patricio,48409,66730,19373,37148,10209,47357
Texas,San Saba,48411,6055,1346,3244,1465,4709
Texas,Schleicher,48413,2793,755,1479,559,2038
Texas,Scurry,48415,16703,4588,9549,2566,12115
Texas,Shackelford,48417,3265,833,1741,691,2432
Texas,Shelby,48419,25274,7202,13540,4532,18072
Texas,Sherman,48421,3022,891,1669,462,2131
Texas,Smith,48423,232751,63646,129768,39337,169105
Texas,Somervell,48425,9128,2212,5146,1770,6916
Texas,Starr,48427,64633,23247,34016,7370,41386
Texas,Stephens,48429,9366,2285,5191,1890,7081
Texas,Sterling,48431,1291,401,704,186,890
Texas,Stonewall,48433,1350,331,658,361,1019
Texas,Sutton,48435,3776,1004,2049,723,2772
Texas,Swisher,48437,7397,2031,4061,1305,5366
Texas,Tarrant,48439,2102515,604927,1253077,244511,1497588
Texas,Taylor,48441,138034,39356,78547,20131,98678
Texas,Terrell,48443,776,161,360,255,615
Texas,Terry,48445,12337,3698,6781,1858,8639
Texas,Throckmorton,48447,1501,312,744,445,1189
Texas,Titus,48449,32750,10382,17523,4845,22368
Texas,Tom Green,48451,119200,32848,67727,18625,86352
Texas,Travis,48453,1273954,303469,840932,129553,970485
Texas,Trinity,48455,14651,3181,7514,3956,11470
Texas,Tyler,48457,21672,4580,12197,4895,17092
Texas,Upshur,48459,41753,10834,23094,7825,30919
Texas,Upton,48461,3657,1138,1982,537,2519
Texas,Uvalde,48463,26741,8053,14180,4508,18688
Texas,Val Verde,48465,49025,15321,26701,7003,33704
Texas,Van Zandt,48467,56590,14307,30788,11495,42283
Texas,Victoria,48469,92084,25791,51051,15242,66293
Texas,Walker,48471,72971,14182,48740,10049,58789
Texas,Waller,48473,55246,17230,31470,6546,38016
Texas,Ward,48475,11998,3771,6598,1629,8227
Texas,Washington,48477,35882,9517,18476,7889,26365
Texas,Webb,48479,276652,99213,150518,26921,177439
Texas,Wharton,48481,41556,11819,22498,7239,29737
Texas,Wheeler,48483,5056,1376,2678,1002,3680
Texas,Wichita,48485,132230,35431,76945,19854,96799
Texas,Wilbarger,48487,12769,3164,7184,2421,9605
Texas,Willacy,48489,21358,5755,12546,3057,15603
Texas,Williamson,48491,590551,162980,354369,73202,427571
Texas,Wilson,48493,51070,13478,29181,8411,37592
Texas,Winkler,48495,8010,2577,4469,964,5433
Texas,Wise,48497,69984,18947,40439,10598,51037
Texas,Wood,48499,45539,9719,23293,12527,35820
Texas,Yoakum,48501,8713,3115,4565,1033,5598
Texas,Young,48503,18010,4672,9564,3774,13338
Texas,Zapata,48505,14179,5103,7210,1866,9076
Texas,Zavala,48507,11840,3765,6352,1723,8075
Utah,Beaver,49001,6710,2372,3392,946,4338
Utah,Box Elder,49003,56046,18947,29700,7399,37099
Utah,Cache,49005,128289,44324,71395,12570,83965
Utah,Carbon,49007,20463,5897,10878,3688,14566
Utah,Daggett,49009,950,230,461,259,720
Utah,Davis,49011,355481,122348,196495,36638,233133
Utah,Duchesne,49013,19938,7148,10309,2481,12790
Utah,Emery,49015,10012,3091,5153,1768,6921
Utah,Garfield,49017,5051,1264,2573,1214,3787
Utah,Grand,49019,9754,2282,5581,1891,7472
Utah,Iron,49021,54839,17930,29839,7070,36909
Utah,Juab,49023,12017,4459,6131,1427,7558
Utah,Kane,49025,7886,2048,3991,1847,5838
Utah,Millard,49027,13188,4434,6406,2348,8754
Utah,Morgan,49029,12124,4562,6117,1445,7562
Utah,Piute,49031,1479,394,669,416,1085
Utah,Rich,49033,2483,787,1238,458,1696
Utah,Salt Lake,49035,1160437,339210,691176,130051,821227
Utah,San Juan,49037,15308,4987,8040,2281,10321
Utah,Sanpete,49039,30939,9354,17097,4488,21585
Utah,Sevier,49041,21620,6845,11208,3567,14775
Utah,Summit,49043,42145,11113,25397,5635,31032
Utah,Tooele,49045,72259,25204,40307,6748,47055
Utah,Uintah,49047,35734,12623,19089,4022,23111
Utah,Utah,49049,636235,235580,350165,50490,400655
Utah,Wasatch,49051,34091,11334,18566,4191,22757
Utah,Washington,49053,177556,49968,88521,39067,127588
Utah,Wayne,49055,2711,718,1396,597,1993
Utah,Weber,49057,260213,79158,150185,30870,181055
Vermont,Addison,50001,36777,7787,21392,7598,28990
Vermont,Bennington,50003,35470,7625,19557,8288,27845
Vermont,Caledonia,50005,29993,6626,16751,6616,23367
Vermont,Chittenden,50007,163774,36586,101707,25481,127188
Vermont,Essex,50009,6163,1149,3379,1635,5014
Vermont,Franklin,50011,49402,11823,29333,8246,37579
Vermont,Grand Isle,50013,7235,1431,4247,1557,5804
Vermont,Lamoille,50015,25362,5867,14954,4541,19495
Vermont,Orange,50017,28892,5929,16597,6366,22963
Vermont,Orleans,50019,27037,5745,15003,6289,21292
Vermont,Rutland,50021,58191,11966,32993,13232,46225
Vermont,Washington,50023,58409,12777,33861,11771,45632
Vermont,Windham,50025,42222,8352,23784,10086,33870
Vermont,Windsor,50027,55062,10752,30977,13333,44310
Virginia,Accomack,51001,32316,7326,17056,7934,24990
Virginia,Albemarle,51003,109330,27074,61101,21155,82256
Virginia,Alleghany,51005,14860,3026,8049,3785,11834
Virginia,Amelia,51007,13145,2994,7514,2637,10151
Virginia,Amherst,51009,31605,6891,17887,6827,24714
Virginia,Appomattox,51011,15911,3679,8866,3366,12232
Virginia,Arlington,51013,236842,46411,164149,26282,190431
Virginia,Augusta,51015,75558,15588,43429,16541,59970
Virginia,Bath,51017,4147,692,2294,1161,3455
Virginia,Bedford,51019,78997,17154,44584,17259,61843
Virginia,Bland,51021,6280,1045,3751,1484,5235
Virginia,Botetourt,51023,33419,6939,18707,7773,26480
Virginia,Brunswick,51025,16231,2967,9730,3534,13264
Virginia,Buchanan,51027,21004,3998,12162,4844,17006
Virginia,Buckingham,51029,17148,3316,10370,3462,13832
Virginia,Campbell,51031,54885,11713,32034,11138,43172
Virginia,Caroline,51033,30725,7579,17940,5206,23146
Virginia,Carroll,51035,29791,5838,16382,7571,23953
Virginia,Charles City,51036,6963,1143,4045,1775,5820
Virginia,Charlotte,51037,11880,2729,6464,2687,9151
Virginia,Chesterfield,51041,352802,92549,205900,54353,260253
Virginia,Clarke,51043,14619,3172,8253,3194,11447
Virginia,Craig,51045,5131,1003,2889,1239,4128
Virginia,Culpeper,51047,52605,14273,29890,8442,38332
Virginia,Cumberland,51049,9932,2088,5554,2290,7844
Virginia,Dickenson,51051,14318,3059,7969,3290,11259
Virginia,Dinwiddie,51053,28544,6378,17045,5121,22166
Virginia,Essex,51057,10953,2230,6123,2600,8723
Virginia,Fairfax,51059,1147532,294101,692970,160461,853431
Virginia,Fauquier,51061,71222,18148,41002,12072,53074
Virginia,Floyd,51063,15749,3357,8694,3698,12392
Virginia,Fluvanna,51065,27270,5938,15732,5600,21332
Virginia,Franklin,51067,56042,11934,30556,13552,44108
Virginia,Frederick,51069,89313,22244,51130,15939,67069
Virginia,Giles,51071,16720,3749,9234,3737,12971
Virginia,Gloucester,51073,37348,8170,21849,7329,29178
Virginia,Goochland,51075,23753,4525,13792,5436,19228
Virginia,Grayson,51077,15550,2848,8764,3938,12702
Virginia,Greene,51079,19819,5126,11158,3535,14693
Virginia,Greensville,51081,11336,2085,7517,1734,9251
Virginia,Halifax,51083,33911,7510,18002,8399,26401
Virginia,Hanover,51085,107766,26224,61752,19790,81542
Virginia,Henrico,51087,330818,81179,196919,52720,249639
Virginia,Henry,51089,50557,10683,27466,12408,39874
Virginia,Highland,51091,2190,315,1097,778,1875
Virginia,Isle of Wight,51093,37109,8436,21308,7365,28673
Virginia,James City,51095,76523,16612,40166,19745,59911
Virginia,King and Queen,51097,7025,1362,4004,1659,5663
Virginia,King George,51099,26836,7182,16050,3604,19654
Virginia,King William,51101,17148,4261,10084,2803,12887
Virginia,Lancaster,51103,10603,1808,4907,3888,8795
Virginia,Lee,51105,23423,4717,13495,5211,18706
Virginia,Loudoun,51107,413538,124988,248400,40150,288550
Virginia,Louisa,51109,37591,8227,21734,7630,29364
Virginia,Lunenburg,51111,12196,2502,6926,2768,9694
Virginia,Madison,51113,13261,2940,7285,3036,10321
Virginia,Mathews,51115,8834,1539,4510,2785,7295
Virginia,Mecklenburg,51117,30587,6246,16433,7908,24341
Virginia,Middlesex,51119,10582,1860,5335,3387,8722
Virginia,Montgomery,51121,98535,23444,62066,13025,75091
Virginia,Nelson,51125,14930,2940,7787,4203,11990
Virginia,New Kent,51127,23091,5038,13965,4088,18053
Virginia,Northampton,51131,11710,2517,6027,3166,9193
Virginia,Northumberland,51133,12095,1941,5614,4540,10154
Virginia,Nottoway,51135,15232,3235,9051,2946,11997
Virginia,Orange,51137,37051,8501,20919,7631,28550
Virginia,Page,51139,23902,5163,13502,5237,18739
Virginia,Patrick,51141,17608,3342,9543,4723,14266
Virginia,Pittsylvania,51143,60354,12346,33916,14092,48008
Virginia,Powhatan,51145,29652,5967,18053,5632,23685
Virginia,Prince Edward,51147,22802,5638,13295,3869,17164
Virginia,Prince George,51149,38353,9363,23459,5531,28990
Virginia,Prince William,51153,470335,137940,283872,48523,332395
Virginia,Pulaski,51155,34027,6582,19464,7981,27445
Virginia,Rappahannock,51157,7370,1332,3985,2053,6038
Virginia,Richmond,51159,9023,1684,5434,1905,7339
Virginia,Roanoke,51161,94186,20562,53090,20534,73624
Virginia,Rockbridge,51163,22573,4403,12122,6048,18170
Virginia,Rockingham,51165,81948,20086,45891,15971,61862
Virginia,Russell,51167,26586,5453,15146,5987,21133
Virginia,Scott,51169,21566,4211,11985,5370,17355
Virginia,Shenandoah,51171,43616,9992,23934,9690,33624
Virginia,Smyth,51173,30104,6378,16924,6802,23726
Virginia,Southampton,51175,17631,3592,10368,3671,14039
Virginia,Spotsylvania,51177,136215,36629,79516,20070,99586
Virginia,Stafford,51179,152882,43632,92833,16417,109250
Virginia,Surry,51181,6422,1182,3708,1532,5240
Virginia,Sussex,51183,11159,1902,7187,2070,9257
Virginia,Tazewell,51185,40595,8640,22597,9358,31955
Virginia,Warren,51187,40164,9634,23788,6742,30530
Virginia,Washington,51191,53740,11032,30006,12702,42708
Virginia,Westmoreland,51193,18015,3739,9657,4619,14276
Virginia,Wise,51195,37383,8108,22110,7165,29275
Virginia,Wythe,51197,28684,6238,16096,6350,22446
Virginia,York,51199,68280,17691,39222,11367,50589
Virginia,Alexandria city,51510,159428,30705,109328,19395,128723
Virginia,Bristol city,51520,16762,3659,9479,3624,13103
Virginia,Buena Vista city,51530,6478,1658,3551,1269,4820
Virginia,Charlottesville city,51540,47266,8931,32545,5790,38335
Virginia,Chesapeake city,51550,244835,64796,146405,33634,180039
Virginia,Colonial Heights city,51570,17370,4465,9469,3436,12905
Virginia,Covington city,51580,5538,1267,3165,1106,4271
Virginia,Danville city,51590,40044,9694,21835,8515,30350
Virginia,Emporia city,51595,5346,1408,2860,1078,3938
Virginia,Fairfax city,51600,24019,6368,14158,3493,17651
Virginia,Falls Church city,51610,14617,3949,8613,2055,10668
Virginia,Franklin city,51620,7967,2247,4201,1519,5720
Virginia,Fredericksburg city,51630,29036,7892,17682,3462,21144
Virginia,Galax city,51640,6347,1640,3517,1190,4707
Virginia,Hampton city,51650,134510,32414,80919,21177,102096
Virginia,Harrisonburg city,51660,53016,15011,32829,5176,38005
Virginia,Hopewell city,51670,22529,6341,12650,3538,16188
Virginia,Lexington city,51678,7446,2294,4028,1124,5152
Virginia,Lynchburg city,51680,82168,22056,48206,11906,60112
Virginia,Manassas city,51683,41085,11908,24739,4438,29177
Virginia,Manassas Park city,51685,17478,4387,11567,1524,13091
Virginia,Martinsville city,51690,12554,3439,6843,2272,9115
Virginia,Newport News city,51700,179225,47634,107699,23892,131591
Virginia,Norfolk city,51710,242742,56077,158558,28107,186665
Virginia,Norton city,51720,3981,949,2286,746,3032
Virginia,Petersburg city,51730,31346,7626,18390,5330,23720
Virginia,Poquoson city,51735,12271,3014,6855,2402,9257
Virginia,Portsmouth city,51740,94398,23740,56366,14292,70658
Virginia,Radford city,51750,18249,4861,11666,1722,13388
Virginia,Richmond city,51760,230436,47711,150916,31809,182725
Virginia,Roanoke city,51770,99143,23941,58451,16751,75202
Virginia,Salem city,51775,25301,6121,14370,4810,19180
Virginia,Staunton city,51790,24932,5361,14226,5345,19571
Virginia,Suffolk city,51800,92108,23991,54413,13704,68117
Virginia,Virginia Beach city,51810,449974,109212,274363,66399,340762
Virginia,Waynesboro city,51820,22630,5790,12809,4031,16840
Virginia,Williamsburg city,51830,14954,3728,8606,2620,11226
Virginia,Winchester city,51840,28078,7394,16084,4600,20684
Washington,Adams,53001,19983,7771,9948,2264,12212
Washington,Asotin,53003,22582,4967,12205,5410,17615
Washington,Benton,53005,204390,59063,113867,31460,145327
Washington,Chelan,53007,77200,19648,42383,15169,57552
Washington,Clallam,53009,77331,14195,39582,23554,63136
Washington,Clark,53011,488241,125633,284666,77942,362608
Washington,Columbia,53013,3985,781,2070,1134,3204
Washington,Cowlitz,53015,110593,27541,61673,21379,83052
Washington,Douglas,53017,43429,12231,23313,7885,31198
Washington,Ferry,53019,7627,1457,4016,2154,6170
Washington,Franklin,53021,95222,33216,52814,9192,62006
Washington,Garfield,53023,2225,510,1151,564,1715
Washington,Grant,53025,97733,31301,52702,13730,66432
Washington,Grays Harbor,53027,75061,16643,41676,16742,58418
Washington,Island,53029,85141,16897,46771,21473,68244
Washington,Jefferson,53031,32221,4192,15802,12227,28029
Washington,King,53033,2252782,500334,1448133,304315,1752448
Washington,Kitsap,53035,271473,60488,161127,49858,210985
Washington,Kittitas,53037,47935,10568,29337,8030,37367
Washington,Klickitat,53039,22425,4691,12234,5500,17734
Washington,Lewis,53041,80707,18889,44618,17200,61818
Washington,Lincoln,53043,10939,2604,5502,2833,8335
Washington,Mason,53045,66768,14208,37012,15548,52560
Washington,Okanogan,53047,42243,10705,22227,9311,31538
Washington,Pacific,53049,22471,3764,11472,7235,18707
Washington,Pend Oreille,53051,13724,2896,7135,3693,10828
Washington,Pierce,53053,904980,231151,545421,128408,673829
Washington,San Juan,53055,17582,2465,8935,6182,15117
Washington,Skagit,53057,129205,30465,70960,27780,98740
Washington,Skamania,53059,12083,2445,6962,2676,9638
Washington,Snohomish,53061,822083,200634,506617,114832,621449
Washington,Spokane,53063,522798,128380,307795,86623,394418
Washington,Stevens,53065,45723,10597,24212,10914,35126
Washington,Thurston,53067,290536,67804,170861,51871,222732
Washington,Wahkiakum,53069,4488,855,2152,1481,3633
Washington,Walla Walla,53071,60760,15005,34391,11364,45755
Washington,Whatcom,53073,229247,51651,136391,41205,177596
Washington,Whitman,53075,50104,12722,32010,5372,37382
Washington,Yakima,53077,250873,80939,134721,35213,169934
West Virginia,Barbour,54001,16441,3804,9237,3400,12637
West Virginia,Berkeley,54003,119171,29855,71381,17935,89316
West Virginia,Boone,54005,21457,4909,12062,4486,16548
West Virginia,Braxton,54007,13957,2918,7733,3306,11039
West Virginia,Brooke,54009,21939,4415,12131,5393,17524
West Virginia,Cabell,54011,91945,21076,53003,17866,70869
West Virginia,Calhoun,54013,7109,1401,3885,1823,5708
West Virginia,Clay,54015,8508,2048,4658,1802,6460
West Virginia,Doddridge,54017,8448,1460,5144,1844,6988
West Virginia,Fayette,54019,42406,9643,23536,9227,32763
West Virginia,Gilmer,54021,7823,1451,4986,1386,6372
West Virginia,Grant,54023,11568,2466,6201,2901,9102
West Virginia,Greenbrier,54025,34662,7408,19118,8136,27254
West Virginia,Hampshire,54027,23175,4645,13100,5430,18530
West Virginia,Hancock,54029,28810,5990,15979,6841,22820
West Virginia,Hardy,54031,13776,3071,7609,3096,10705
West Virginia,Harrison,54033,67256,15586,38370,13300,51670
West Virginia,Jackson,54035,28576,6613,15998,5965,21963
West Virginia,Jefferson,54037,57146,14150,33432,9564,42996
West Virginia,Kanawha,54039,178124,39278,101105,37741,138846
West Virginia,Lewis,54041,15907,3626,8918,3363,12281
West Virginia,Lincoln,54043,20409,4912,11421,4076,15497
West Virginia,Logan,54045,32019,7176,18103,6740,24843
West Virginia,McDowell,54047,17624,3888,9712,4024,13736
West Virginia,Marion,54049,56072,13001,31987,11084,43071
West Virginia,Marshall,54051,30531,6395,17115,7021,24136
West Virginia,Mason,54053,26516,5982,14797,5737,20534
West Virginia,Mercer,54055,58758,13492,32099,13167,45266
West Virginia,Mineral,54057,26868,6100,14817,5951,20768
West Virginia,Mingo,54059,23424,5680,13109,4635,17744
West Virginia,Monongalia,54061,105612,22992,68656,13964,82620
West Virginia,Monroe,54063,13275,2835,7064,3376,10440
West Virginia,Morgan,54065,17884,3521,10100,4263,14363
West Virginia,Nicholas,54067,24496,5461,13423,5612,19035
West Virginia,Ohio,54069,41411,9290,22916,9205,32121
West Virginia,Pendleton,54071,6969,1374,3632,1963,5595
West Virginia,Pleasants,54073,7460,1526,4473,1461,5934
West Virginia,Pocahontas,54075,8247,1545,4545,2157,6702
West Virginia,Preston,54077,33432,6903,19548,6981,26529
West Virginia,Putnam,54079,56450,13571,32211,10668,42879
West Virginia,Raleigh,54081,73361,16612,41199,15550,56749
West Virginia,Randolph,54083,28695,6091,16228,6376,22604
West Virginia,Ritchie,54085,9554,2028,5331,2195,7526
West Virginia,Roane,54087,13688,3049,7519,3120,10639
West Virginia,Summers,54089,12573,2226,7064,3283,10347
West Virginia,Taylor,54091,16695,3575,9613,3507,13120
West Virginia,Tucker,54093,6839,1141,3863,1835,5698
West Virginia,Tyler,54095,8591,1827,4752,2012,6764
West Virginia,Upshur,54097,24176,5726,13381,5069,18450
West Virginia,Wayne,54099,39402,8750,22092,8560,30652
West Virginia,Webster,54101,8114,1738,4425,1951,6376
West Virginia,Wetzel,54103,15065,3278,8287,3500,11787
West Virginia,Wirt,54105,5821,1345,3263,1213,4476
West Virginia,Wood,54107,83518,19087,46967,17464,64431
West Virginia,Wyoming,54109,20394,4543,11365,4486,15851
Wisconsin,Adams,55001,20220,3166,10956,6098,17054
Wisconsin,Ashland,55003,15562,3861,8550,3151,11701
Wisconsin,Barron,55005,45244,10576,24455,10213,34668
Wisconsin,Bayfield,55007,15036,2862,7929,4245,12174
Wisconsin,Brown,55009,264542,69196,154540,40806,195346
Wisconsin,Buffalo,55011,13031,2923,7141,2967,10108
Wisconsin,Burnett,55013,15414,2934,7952,4528,12480
Wisconsin,Calumet,55015,50089,12818,29409,7862,37271
Wisconsin,Chippewa,55017,64658,15389,37353,11916,49269
Wisconsin,Clark,55019,34774,11090,17759,5925,23684
Wisconsin,Columbia,55021,57532,13261,33692,10579,44271
Wisconsin,Crawford,55023,16131,3574,8690,3867,12557
Wisconsin,Dane,55025,546695,127724,341200,77771,418971
Wisconsin,Dodge,55027,87839,18996,52847,15996,68843
Wisconsin,Door,55029,27668,4962,14269,8437,22706
Wisconsin,Douglas,55031,43150,9526,25336,8288,33624
Wisconsin,Dunn,55033,45368,11404,26666,7298,33964
Wisconsin,Eau Claire,55035,104646,25291,62397,16958,79355
Wisconsin,Florence,55037,4295,676,2457,1162,3619
Wisconsin,Fond du Lac,55039,103403,24535,59216,19652,78868
Wisconsin,Forest,55041,9004,2009,4917,2078,6995
Wisconsin,Grant,55043,51439,13671,28689,9079,37768
Wisconsin,Green,55045,36960,8893,20949,7118,28067
Wisconsin,Green Lake,55047,18913,4562,10037,4314,14351
Wisconsin,Iowa,55049,23678,5752,13316,4610,17926
Wisconsin,Iron,55051,5687,941,2923,1823,4746
Wisconsin,Jackson,55053,20643,4933,11735,3975,15710
Wisconsin,Jefferson,55055,84769,20373,49421,14975,64396
Wisconsin,Juneau,55057,26687,5813,15310,5564,20874
Wisconsin,Kenosha,55059,169561,43186,101669,24706,126375
Wisconsin,Kewaunee,55061,20434,4825,11333,4276,15609
Wisconsin,La Crosse,55063,118016,28282,69800,19934,89734
Wisconsin,Lafayette,55065,16665,4371,9065,3229,12294
Wisconsin,Langlade,55067,19189,4122,10328,4739,15067
Wisconsin,Lincoln,55069,27593,5507,15968,6118,22086
Wisconsin,Manitowoc,55071,78981,17795,44506,16680,61186
Wisconsin,Marathon,55073,135692,33604,77406,24682,102088
Wisconsin,Marinette,55075,40350,8386,22070,9894,31964
Wisconsin,Marquette,55077,15574,3263,8404,3907,12311
Wisconsin,Menominee,55078,4556,1648,2271,637,2908
Wisconsin,Milwaukee,55079,945726,251630,561806,132290,694096
Wisconsin,Monroe,55081,46253,12638,25517,8098,33615
Wisconsin,Oconto,55083,37930,8356,21658,7916,29574
Wisconsin,Oneida,55085,35595,6622,19475,9498,28973
Wisconsin,Outagamie,55087,187885,48270,110953,28662,139615
Wisconsin,Ozaukee,55089,89221,21370,49686,18165,67851
Wisconsin,Pepin,55091,7287,1651,3922,1714,5636
Wisconsin,Pierce,55093,42754,11008,25223,6523,31746
Wisconsin,Polk,55095,43783,9814,24635,9334,33969
Wisconsin,Portage,55097,70772,16636,41874,12262,54136
Wisconsin,Price,55099,13351,2646,7172,3533,10705
Wisconsin,Racine,55101,196311,49367,113302,33642,146944
Wisconsin,Richland,55103,17252,4117,9071,4064,13135
Wisconsin,Rock,55105,163354,41477,93979,27898,121877
Wisconsin,Rusk,55107,14178,3159,7500,3519,11019
Wisconsin,St. Croix,55109,90687,24223,53145,13319,66464
Wisconsin,Sauk,55111,64442,15915,36246,12281,48527
Wisconsin,Sawyer,55113,16558,3481,8660,4417,13077
Wisconsin,Shawano,55115,40899,9517,22557,8825,31382
Wisconsin,Sheboygan,55117,115340,27829,66117,21394,87511
Wisconsin,Taylor,55119,20343,5193,11170,3980,15150
Wisconsin,Trempealeau,55121,29649,8043,16137,5469,21606
Wisconsin,Vernon,55123,30822,8690,15980,6152,22132
Wisconsin,Vilas,55125,22195,4102,11207,6886,18093
Wisconsin,Walworth,55127,103868,24844,59959,19065,79024
Wisconsin,Washburn,55129,15720,3231,8185,4304,12489
Wisconsin,Washington,55131,136034,32336,78570,25128,103698
Wisconsin,Waukesha,55133,404198,95452,231195,77551,308746
Wisconsin,Waupaca,55135,50990,11308,28821,10861,39682
Wisconsin,Waushara,55137,24443,4894,13429,6120,19549
Wisconsin,Winnebago,55139,171907,40411,102588,28908,131496
Wisconsin,Wood,55141,72999,17165,40426,15408,55834
Wyoming,Albany,56001,38880,8606,25522,4752,30274
Wyoming,Big Horn,56003,11790,3157,6055,2578,8633
Wyoming,Campbell,56005,46341,13704,27668,4969,32637
Wyoming,Carbon,56007,14800,3669,8465,2666,11131
Wyoming,Converse,56009,13822,3671,7772,2379,10151
Wyoming,Crook,56011,7584,2014,3968,1602,5570
Wyoming,Fremont,56013,39261,10925,20949,7387,28336
Wyoming,Goshen,56015,13211,2994,7266,2951,10217
Wyoming,Hot Springs,56017,4413,987,2205,1221,3426
Wyoming,Johnson,56019,8445,1965,4402,2078,6480
Wyoming,Laramie,56021,99500,25152,57958,16390,74348
Wyoming,Lincoln,56023,19830,5650,10604,3576,14180
Wyoming,Natrona,56025,79858,20883,46258,12717,58975
Wyoming,Niobrara,56027,2356,456,1350,550,1900
Wyoming,Park,56029,29194,6621,15450,7123,22573
Wyoming,Platte,56031,8393,1853,4363,2177,6540
Wyoming,Sheridan,56033,30485,7186,16692,6607,23299
Wyoming,Sublette,56035,9831,2340,5474,2017,7491
Wyoming,Sweetwater,56037,42343,12049,24805,5489,30294
Wyoming,Teton,56039,23464,4586,15161,3717,18878
Wyoming,Uinta,56041,20226,6215,10986,3025,14011
Wyoming,Washakie,56043,7805,1960,4115,1730,5845
Wyoming,Weston,56045,6927,1529,3920,1478,5398
Puerto Rico,Adjuntas,72001,17363,3752,10066,3545,13611
Puerto Rico,Aguada,72003,36694,7040,22226,7428,29654
Puerto Rico,Aguadilla,72005,50265,10569,28411,11285,39696
Puerto Rico,Aguas Buenas,72007,24814,5130,14514,5170,19684
Puerto Rico,Aibonito,72009,22108,4470,12797,4841,17638
Puerto Rico,Anasco,72011,26161,5081,15503,5577,21080
Puerto Rico,Arecibo,72013,81966,16529,47080,18357,65437
Puerto Rico,Arroyo,72015,17238,3938,9792,3508,13300
Puerto Rico,Barceloneta,72017,23727,5058,13897,4772,18669
Puerto Rico,Barranquitas,72019,27725,6641,16430,4654,21084
Puerto Rico,Bayamon,72021,169269,32894,98211,38164,136375
Puerto Rico,Cabo Rojo,72023,47515,9185,27036,11294,38330
Puerto Rico,Caguas,72025,124606,25499,73010,26097,99107
Puerto Rico,Camuy,72027,30504,6086,18067,6351,24418
Puerto Rico,Canovanas,72029,44674,9761,26985,7928,34913
Puerto Rico,Carolina,72031,146984,28989,83977,34018,117995
Puerto Rico,Catano,72033,23121,4947,13296,4878,18174
Puerto Rico,Cayey,72035,42409,8507,24766,9136,33902
Puerto Rico,Ceiba,72037,10904,2127,6106,2671,8777
Puerto Rico,Ciales,72039,15808,3293,9154,3361,12515
Puerto Rico,Cidra,72041,38307,8212,23006,7089,30095
Puerto Rico,Coamo,72043,38336,7977,23245,7114,30359
Puerto Rico,Comerio,72045,18648,4019,11066,3563,14629
Puerto Rico,Corozal,72047,32293,7199,18940,6154,25094
Puerto Rico,Culebra,72049,1714,336,987,391,1378
Puerto Rico,Dorado,72051,36141,8275,21336,6530,27866
Puerto Rico,Fajardo,72053,29454,6183,16624,6647,23271
Puerto Rico,Florida,72054,11317,2479,6675,2163,8838
Puerto Rico,Guanica,72055,15383,3278,8261,3844,12105
Puerto Rico,Guayama,72057,39465,8495,23440,7530,30970
Puerto Rico,Guayanilla,72059,17623,3860,9936,3827,13763
Puerto Rico,Guaynabo,72061,83728,14770,49618,19340,68958
Puerto Rico,Gurabo,72063,47093,10111,29181,7801,36982
Puerto Rico,Hatillo,72065,39218,7684,23244,8290,31534
Puerto Rico,Hormigueros,72067,15518,2794,8277,4447,12724
Puerto Rico,Humacao,72069,50653,10198,28677,11778,40455
Puerto Rico,Isabela,72071,40423,7998,24069,8356,32425
Puerto Rico,Jayuya,72073,13891,3256,8185,2450,10635
Puerto Rico,Juana Diaz,72075,44679,10180,26207,8292,34499
Puerto Rico,Juncos,72077,38155,8598,23194,6363,29557
Puerto Rico,Lajas,72079,22010,4220,12255,5535,17790
Puerto Rico,Lares,72081,24276,4917,14128,5231,19359
Puerto Rico,Las Marias,72083,7927,1727,4475,1725,6200
Puerto Rico,Las Piedras,72085,37007,7885,22080,7042,29122
Puerto Rico,Loiza,72087,24553,5379,14446,4728,19174
Puerto Rico,Luquillo,72089,17665,3644,10072,3949,14021
Puerto Rico,Manati,72091,37287,7852,21002,8433,29435
Puerto Rico,Maricao,72093,5430,1090,3139,1201,4340
Puerto Rico,Maunabo,72095,10321,2045,5850,2426,8276
Puerto Rico,Mayaguez,72097,71530,14952,38812,17766,56578
Puerto Rico,Moca,72099,34891,7613,20858,6420,27278
Puerto Rico,Morovis,72101,30335,6694,18515,5126,23641
Puerto Rico,Naguabo,72103,25761,6043,14889,4829,19718
Puerto Rico,Naranjito,72105,27349,5833,15930,5586,21516
Puerto Rico,Orocovis,72107,20220,4514,12085,3621,15706
Puerto Rico,Patillas,72109,16211,3146,9279,3786,13065
Puerto Rico,Penuelas,72111,19249,4662,11237,3350,14587
Puerto Rico,Ponce,72113,131881,28245,73562,30074,103636
Puerto Rico,Quebradillas,72115,22918,4744,13337,4837,18174
Puerto Rico,Rincon,72117,13656,2462,7712,3482,11194
Puerto Rico,Rio Grande,72119,48025,9719,28343,9963,38306
Puerto Rico,Sabana Grande,72121,21712,4492,12059,5161,17220
Puerto Rico,Salinas,72123,27128,6245,15356,5527,20883
Puerto Rico,San German,72125,30227,6305,16260,7662,23922
Puerto Rico,San Juan,72127,318441,62085,181573,74783,256356
Puerto Rico,San Lorenzo,72129,35989,7195,21641,7153,28794
Puerto Rico,San Sebastian,72131,35528,7195,19767,8566,28333
Puerto Rico,Santa Isabel,72133,21209,4876,12775,3558,16333
Puerto Rico,Toa Alta,72135,72025,15768,45478,10779,56257
Puerto Rico,Toa Baja,72137,74271,15488,43697,15086,58783
Puerto Rico,Trujillo Alto,72139,63674,13198,37768,12708,50476
Puerto Rico,Utuado,72141,27395,5681,15451,6263,21714
Puerto Rico,Vega Alta,72143,36061,8048,21120,6893,28013
Puerto Rico,Vega Baja,72145,50023,10377,29083,10563,39646
Puerto Rico,Vieques,72147,8386,1695,4796,1895,6691
Puerto Rico,Villalba,72149,21372,4929,12463,3980,16443
Puerto Rico,Yabucoa,72151,32282,6507,18612,7163,25775
Puerto Rico,Yauco,72153,33575,6655,19118,7802,26920
Virgin Islands,St. Croix,78010,"50,601",12592,27562,10447,38009
Virgin Islands,St. John,78020,4170,1051,2316,803,3119
Virgin Islands,St. Thomas,78030,51634,12872,28091,10671,38762
,,,,,,,
,,,,,,,
,,,,,,,
,,,,,,,
,,,,,,,
,,,,,,,
,,,,,,,
