state,county,fips,POP tot,0-19 tot,20-64tot,65+ tot,voting age
Texas,Anderson,48001,57735,12087,36990,8658,45648
Texas,Andrews,48003,18705,6323,10549,1833,12382
Texas,Angelina,48005,86715,24237,48056,14422,62478
Texas,Aransas,48007,23510,4588,12131,6791,18922
Texas,Archer,48009,8553,2029,4847,1677,6524
Texas,Armstrong,48011,1887,462,955,470,1425
Texas,Atascosa,48013,51153,15278,28270,7605,35875
Texas,Austin,48015,30032,7839,16260,5933,22193
Texas,Bailey,48017,7000,2367,3597,1036,4633
Texas,Bandera,48019,23112,4199,12474,6439,18913
Texas,Bastrop,48021,88723,24793,50065,13865,63930
Texas,Baylor,48023,3509,872,1793,844,2637
Texas,Bee,48025,32565,7786,20688,4091,24779
Texas,Bell,48027,362924,110277,212113,40534,252647
Texas,Bexar,48029,2003554,565620,1190091,247843,1437934
Texas,Blanco,48031,11931,2379,6548,3004,9552
Texas,Borden,48033,654,142,338,174,512
Texas,Bosque,48035,18685,4299,9645,4741,14386
Texas,Bowie,48037,93245,24090,53323,15832,69155
Texas,Brazoria,48039,374264,106958,221554,45752,267306
Texas,Brazos,48041,229211,61743,145775,21693,167468
Texas,Brewster,48043,9203,1861,5111,2231,7342
Texas,Briscoe,48045,1546,332,810,404,1214
Texas,Brooks,48047,7093,2137,3648,1308,4956
Texas,Brown,48049,37864,9244,20900,7720,28620
Texas,Burleson,48051,18443,4424,10152,3867,14019
Texas,Burnet,48053,48155,11167,25989,10999,36988
Texas,Caldwell,48055,43664,11670,25482,6512,31994
Texas,Calhoun,48057,21290,5621,11688,3981,15669
Texas,Callahan,48059,13943,3335,7650,2958,10608
Texas,Cameron,48061,423163,140542,224014,58607,282621
Texas,Camp,48063,13094,3746,6854,2494,9348
Texas,Carson,48065,5926,1514,3162,1250,4412
Texas,Cass,48067,30026,7305,15865,6856,22721
Texas,Castro,48069,7530,2368,3926,1236,5162
Texas,Chambers,48071,43837,13330,25248,5259,30507
Texas,Cherokee,48073,52646,14930,28272,9444,37716
Texas,Childress,48075,7306,1554,4587,1165,5752
Texas,Clay,48077,10471,2282,5705,2484,8189
Texas,Cochran,48079,2853,832,1553,468,2021
Texas,Coke,48081,3387,797,1643,947,2590
Texas,Coleman,48083,8175,1840,4216,2119,6335
Texas,Collin,48085,1034730,291011,627144,116575,743719
Texas,Collingsworth,48087,2920,800,1565,555,2120
Texas,Colorado,48089,21493,5446,11197,4850,16047
Texas,Comal,48091,156209,38518,89163,28528,117691
Texas,Comanche,48093,13635,3314,6991,3330,10321
Texas,Concho,48095,2726,549,1488,689,2177
Texas,Cooke,48097,41257,10698,22755,7804,30559
Texas,Coryell,48099,75951,19012,48899,8040,56939
Texas,Cottle,48101,1398,358,701,339,1040
Texas,Crane,48103,4797,1530,2673,594,3267
Texas,Crockett,48105,3464,938,1914,612,2526
Texas,Crosby,48107,5737,1655,2997,1085,4082
Texas,Culberson,48109,2171,535,1156,480,1636
Texas,Dallam,48111,7287,2523,3907,857,4764
Texas,Dallas,48113,2635516,749026,1594373,292117,1886490
Texas,Dawson,48115,12728,3626,7204,1898,9102
Texas,Deaf Smith,48117,18546,6296,9827,2423,12250
Texas,Delta,48119,5331,1381,2832,1118,3950
Texas,Denton,48121,887207,239747,553961,93499,647460
Texas,DeWitt,48123,20160,4962,11163,4035,15198
Texas,Dickens,48125,2211,468,1218,525,1743
Texas,Dimmit,48127,10124,3198,5177,1749,6926
Texas,Donley,48129,3278,842,1632,804,2436
Texas,Duval,48131,11157,3142,5984,2031,8015
Texas,Eastland,48133,18360,4608,9698,4054,13752
Texas,Ector,48135,166223,54911,95342,15970,111312
Texas,Edwards,48137,1932,458,913,561,1474
Texas,Ellis,48139,184826,53743,106795,24288,131083
Texas,El Paso,48141,839238,249839,484224,105175,589399
Texas,Erath,48143,42698,11948,24494,6256,30750
Texas,Falls,48145,17297,3974,10097,3226,13323
Texas,Fannin,48147,35514,8277,20649,6588,27237
Texas,Fayette,48149,25346,5548,13119,6679,19798
Texas,Fisher,48151,3830,897,1972,961,2933
Texas,Floyd,48153,5712,1660,2982,1070,4052
Texas,Foard,48155,1155,252,588,315,903
Texas,Fort Bend,48157,811688,242562,475275,93851,569126
Texas,Franklin,48159,10725,2721,5637,2367,8004
Texas,Freestone,48161,19717,4942,10779,3996,14775
Texas,Frio,48163,20306,5405,12402,2499,14901
Texas,Gaines,48165,21492,8393,11192,1907,13099
Texas,Galveston,48167,342139,91147,200005,50987,250992
Texas,Garza,48169,6229,1253,4257,719,4976
Texas,Gillespie,48171,26988,5868,13010,8110,21120
Texas,Glasscock,48173,1409,386,813,210,1023
Texas,Goliad,48175,7658,1753,4073,1832,5905
Texas,Gonzales,48177,20837,6122,11143,3572,14715
Texas,Gray,48179,21886,6021,12334,3531,15865
Texas,Grayson,48181,136212,35792,76238,24182,100420
Texas,Gregg,48183,123945,35155,69339,19451,88790
Texas,Grimes,48185,28880,7069,16677,5134,21811
Texas,Guadalupe,48187,166847,45879,97354,23614,120968
Texas,Hale,48189,33406,10046,18756,4604,23360
Texas,Hall,48191,2964,728,1525,711,2236
Texas,Hamilton,48193,8461,2004,4311,2146,6457
Texas,Hansford,48195,5399,1794,2793,812,3605
Texas,Hardeman,48197,3933,920,2101,912,3013
Texas,Hardin,48199,57602,15290,32550,9762,42312
Texas,Harris,48201,4713325,1367692,2831466,514167,3345633
Texas,Harrison,48203,66553,18280,36666,11607,48273
Texas,Hartley,48205,5576,1254,3461,861,4322
Texas,Haskell,48207,5658,1081,3311,1266,4577
Texas,Hays,48209,230191,62287,141717,26187,167904
Texas,Hemphill,48211,3819,1271,1942,606,2548
Texas,Henderson,48213,82737,19535,44668,18534,63202
Texas,Hidalgo,48215,868707,308514,461865,98328,560193
Texas,Hill,48217,36649,9422,19543,7684,27227
Texas,Hockley,48219,23021,6879,12689,3453,16142
Texas,Hood,48221,61643,14110,32117,15416,47533
Texas,Hopkins,48223,37084,9839,20358,6887,27245
Texas,Houston,48225,22968,4938,12854,5176,18030
Texas,Howard,48227,36664,9060,22791,4813,27604
Texas,Hudspeth,48229,4886,1114,2997,775,3772
Texas,Hunt,48231,98594,26515,56269,15810,72079
Texas,Hutchinson,48233,20938,5859,11498,3581,15079
Texas,Irion,48235,1536,376,832,328,1160
Texas,Jack,48237,8935,2169,5251,1515,6766
Texas,Jackson,48239,14760,4099,7941,2720,10661
Texas,Jasper,48241,35529,9183,19159,7187,26346
Texas,Jeff Davis,48243,2274,181,1281,812,2093
Texas,Jefferson,48245,251565,67182,146788,37595,184383
Texas,Jim Hogg,48247,5200,1738,2572,890,3462
Texas,Jim Wells,48249,40482,12211,21913,6358,28271
Texas,Johnson,48251,175817,49947,100719,25151,125870
Texas,Jones,48253,20083,3919,12976,3188,16164
Texas,Karnes,48255,15601,3726,9664,2211,11875
Texas,Kaufman,48257,136154,41427,78614,16113,94727
Texas,Kendall,48259,47431,12167,26112,9152,35264
Texas,Kenedy,48261,404,116,220,68,288
Texas,Kent,48263,762,184,377,201,578
Texas,Kerr,48265,52600,11330,26501,14769,41270
Texas,Kimble,48267,4337,867,2182,1288,3470
Texas,King,48269,272,74,147,51,198
Texas,Kinney,48271,3667,785,1972,910,2882
Texas,Kleberg,48273,30680,8919,17715,4046,21761
Texas,Knox,48275,3664,1048,1880,736,2616
Texas,Lamar,48277,49859,12910,27223,9726,36949
Texas,Lamb,48279,12893,3914,6739,2240,8979
Texas,Lampasas,48281,21428,5140,11966,4322,16288
Texas,La Salle,48283,7520,1689,4813,1018,5831
Texas,Lavaca,48285,20154,5135,10244,4775,15019
Texas,Lee,48287,17239,4187,9833,3219,13052
Texas,Leon,48289,17404,4266,8804,4334,13138
Texas,Liberty,48291,88219,26063,50757,11399,62156
Texas,Limestone,48293,23437,5759,13008,4670,17678
Texas,Lipscomb,48295,3233,894,1722,617,2339
Texas,Live Oak,48297,12207,2671,7003,2533,9536
Texas,Llano,48299,21795,3609,10067,8119,18186
Texas,Loving,48301,169,54,92,23,115
Texas,Lubbock,48303,310569,87857,183236,39476,222712
Texas,Lynn,48305,5951,1772,3205,974,4179
Texas,McCulloch,48307,7984,1944,4248,1792,6040
Texas,McLennan,48309,256623,73177,145718,37728,183446
Texas,McMullen,48311,743,161,393,189,582
Texas,Madison,48313,14284,3410,8610,2264,10874
Texas,Marion,48315,9854,1941,5216,2697,7913
Texas,Martin,48317,5771,1976,3136,659,3795
Texas,Mason,48319,4274,940,2084,1250,3334
Texas,Matagorda,48321,36643,10264,19988,6391,26379
Texas,Maverick,48323,58722,20232,31487,7003,38490
Texas,Medina,48325,51584,13317,29510,8757,38267
Texas,Menard,48327,2138,425,1014,699,1713
Texas,Midland,48329,176832,54552,103842,18438,122280
Texas,Milam,48331,24823,6472,13106,5245,18351
Texas,Mills,48333,4873,1092,2365,1416,3781
Texas,Mitchell,48335,8545,1984,5302,1259,6561
Texas,Montague,48337,19818,4867,10507,4444,14951
Texas,Montgomery,48339,607391,173183,352751,81457,434208
Texas,Moore,48341,20940,7190,11378,2372,13750
Texas,Morris,48343,12388,3114,6544,2730,9274
Texas,Motley,48345,1200,261,571,368,939
Texas,Nacogdoches,48347,65204,18954,36297,9953,46250
Texas,Navarro,48349,50113,14552,26910,8651,35561
Texas,Newton,48351,13595,2996,7721,2878,10599
Texas,Nolan,48353,14714,4265,7712,2737,10449
Texas,Nueces,48355,362294,98400,209825,54069,263894
Texas,Ochiltree,48357,9836,3328,5360,1148,6508
Texas,Oldham,48359,2112,534,1262,316,1578
Texas,Orange,48361,83396,22415,47252,13729,60981
Texas,Palo Pinto,48363,29189,7392,15904,5893,21797
Texas,Panola,48365,23194,6020,12585,4589,17174
Texas,Parker,48367,142878,38659,81888,22331,104219
Texas,Parmer,48369,9605,2979,5260,1366,6626
Texas,Pecos,48371,15823,4272,9410,2141,11551
Texas,Polk,48373,51353,11193,30427,9733,40160
Texas,Potter,48375,117415,34818,67394,15203,82597
Texas,Presidio,48377,6704,1956,3147,1601,4748
Texas,Rains,48379,12514,2750,6641,3123,9764
Texas,Randall,48381,137713,36931,79358,21424,100782
Texas,Reagan,48383,3849,1219,2203,427,2630
Texas,Real,48385,3452,623,1776,1053,2829
Texas,Red River,48387,12023,2587,6392,3044,9436
Texas,Reeves,48389,15976,3988,10110,1878,11988
Texas,Refugio,48391,6948,1706,3625,1617,5242
Texas,Roberts,48393,854,225,436,193,629
Texas,Robertson,48395,17074,4414,9248,3412,12660
Texas,Rockwall,48397,104915,30717,60803,13395,74198
Texas,Runnels,48399,10264,2617,5494,2153,7647
Texas,Rusk,48401,54406,13338,31871,9197,41068
Texas,Sabine,48403,10542,2090,5185,3267,8452
Texas,San Augustine,48405,8237,1756,4254,2227,6481
Texas,San Jacinto,48407,28859,6715,15656,6488,22144
Texas,San Patricio,48409,66730,19373,37148,10209,47357
Texas,San Saba,48411,6055,1346,3244,1465,4709
Texas,Schleicher,48413,2793,755,1479,559,2038
Texas,Scurry,48415,16703,4588,9549,2566,12115
Texas,Shackelford,48417,3265,833,1741,691,2432
Texas,Shelby,48419,25274,7202,13540,4532,18072
Texas,Sherman,48421,3022,891,1669,462,2131
Texas,Smith,48423,232751,63646,129768,39337,169105
Texas,Somervell,48425,9128,2212,5146,1770,6916
Texas,Starr,48427,64633,23247,34016,7370,41386
Texas,Stephens,48429,9366,2285,5191,1890,7081
Texas,Sterling,48431,1291,401,704,186,890
Texas,Stonewall,48433,1350,331,658,361,1019
Texas,Sutton,48435,3776,1004,2049,723,2772
Texas,Swisher,48437,7397,2031,4061,1305,5366
Texas,Tarrant,48439,2102515,604927,1253077,244511,1497588
Texas,Taylor,48441,138034,39356,78547,20131,98678
Texas,Terrell,48443,776,161,360,255,615
Texas,Terry,48445,12337,3698,6781,1858,8639
Texas,Throckmorton,48447,1501,312,744,445,1189
Texas,Titus,48449,32750,10382,17523,4845,22368
Texas,Tom Green,48451,119200,32848,67727,18625,86352
Texas,Travis,48453,1273954,303469,840932,129553,970485
Texas,Trinity,48455,14651,3181,7514,3956,11470
Texas,Tyler,48457,21672,4580,12197,4895,17092
Texas,Upshur,48459,41753,10834,23094,7825,30919
Texas,Upton,48461,3657,1138,1982,537,2519
Texas,Uvalde,48463,26741,8053,14180,4508,18688
Texas,Val Verde,48465,49025,15321,26701,7003,33704
Texas,Van Zandt,48467,56590,14307,30788,11495,42283
Texas,Victoria,48469,92084,25791,51051,15242,66293
Texas,Walker,48471,72971,14182,48740,10049,58789
Texas,Waller,48473,55246,17230,31470,6546,38016
Texas,Ward,48475,11998,3771,6598,1629,8227
Texas,Washington,48477,35882,9517,18476,7889,26365
Texas,Webb,48479,276652,99213,150518,26921,177439
Texas,Wharton,48481,41556,11819,22498,7239,29737
Texas,Wheeler,48483,5056,1376,2678,1002,3680
Texas,Wichita,48485,132230,35431,76945,19854,96799
Texas,Wilbarger,48487,12769,3164,7184,2421,9605
Texas,Willacy,48489,21358,5755,12546,3057,15603
Texas,Williamson,48491,590551,162980,354369,73202,427571
Texas,Wilson,48493,51070,13478,29181,8411,37592
Texas,Winkler,48495,8010,2577,4469,964,5433
Texas,Wise,48497,69984,18947,40439,10598,51037
Texas,Wood,48499,45539,9719,23293,12527,35820
Texas,Yoakum,48501,8713,3115,4565,1033,5598
Texas,Young,48503,18010,4672,9564,3774,13338
Texas,Zapata,48505,14179,5103,7210,1866,9076
Texas,Zavala,48507,11840,3765,6352,1723,8075
